,level_0,index,Id,municipio,departamento,Si,No,validos,nulos,nomarcados,total votos,habilitados,TIPO DE VICTIMA,TOTAL
0,0,71,60001,LETICIA,AMAZONAS,4403,4463,8866,84,40,8990,34592,Víctimas reconocidas Sentencia C280 y Auto 119 de 2013,91
1,1,73,60022,TARAPACA,AMAZONAS,265,68,333,4,7,344,1304,Víctimas de conflicto armado,16
2,2,72,60001,LETICIA,AMAZONAS,4403,4463,8866,84,40,8990,34592,Víctimas de conflicto armado,2376
3,123,1216,01106,CHIGORODO,ANTIOQUIA,6322,5745,12067,187,138,12392,44791,Víctimas reconocidas Sentencia C280 y Auto 119 de 2013,1197
4,124,1207,01078,CARACOLI,ANTIOQUIA,578,593,1171,12,16,1199,4856,Víctimas de conflicto armado,626
5,125,1206,01078,CARACOLI,ANTIOQUIA,578,593,1171,12,16,1199,4856,Víctimas reconocidas Sentencia C280 y Auto 119 de 2013,17
6,126,1205,01076,CAÑASGORDAS,ANTIOQUIA,1911,2739,4650,121,113,4884,13402,Víctimas de conflicto armado,3756
7,127,1190,01055,BETULIA,ANTIOQUIA,1005,1919,2924,49,50,3023,13377,Víctimas reconocidas Sentencia C280 y Auto 119 de 2013,69
8,128,1191,01055,BETULIA,ANTIOQUIA,1005,1919,2924,49,50,3023,13377,Víctimas de conflicto armado,13386
9,129,1192,01062,BRICEÑO,ANTIOQUIA,1367,604,1971,45,62,2078,6169,Víctimas reconocidas Sentencia C280 y Auto 119 de 2013,61
10,130,1193,01062,BRICEÑO,ANTIOQUIA,1367,604,1971,45,62,2078,6169,Víctimas de conflicto armado,2557
11,131,1194,01061,BURITICA,ANTIOQUIA,474,890,1364,20,22,1406,6829,Víctimas reconocidas Sentencia C280 y Auto 119 de 2013,14
12,133,1196,01064,CACERES,ANTIOQUIA,2506,1358,3864,83,57,4004,19788,Víctimas reconocidas Sentencia C280 y Auto 119 de 2013,841
13,122,1222,01097,CONCEPCION,ANTIOQUIA,572,931,1503,27,23,1553,4409,Víctimas reconocidas Sentencia C280 y Auto 119 de 2013,6
14,134,1197,01064,CACERES,ANTIOQUIA,2506,1358,3864,83,57,4004,19788,Víctimas de conflicto armado,7527
15,135,1198,01067,CAICEDO,ANTIOQUIA,593,921,1514,43,43,1600,6091,Víctimas reconocidas Sentencia C280 y Auto 119 de 2013,19
16,136,1199,01067,CAICEDO,ANTIOQUIA,593,921,1514,43,43,1600,6091,Víctimas de conflicto armado,891
17,137,1200,01070,CALDAS,ANTIOQUIA,9292,16149,25441,397,123,25961,60580,Víctimas reconocidas Sentencia C280 y Auto 119 de 2013,209
18,138,1201,01070,CALDAS,ANTIOQUIA,9292,16149,25441,397,123,25961,60580,Víctimas de conflicto armado,3495
19,139,1202,01073,CAMPAMENTO,ANTIOQUIA,619,604,1223,41,32,1296,6360,Víctimas reconocidas Sentencia C280 y Auto 119 de 2013,41
20,140,1203,01073,CAMPAMENTO,ANTIOQUIA,619,604,1223,41,32,1296,6360,Víctimas de conflicto armado,1857
21,141,1204,01076,CAÑASGORDAS,ANTIOQUIA,1911,2739,4650,121,113,4884,13402,Víctimas reconocidas Sentencia C280 y Auto 119 de 2013,137
22,132,1195,01061,BURITICA,ANTIOQUIA,474,890,1364,20,22,1406,6829,Víctimas de conflicto armado,4182
23,121,1221,01094,COCORNA,ANTIOQUIA,1647,3006,4653,81,130,4864,12965,Víctimas de conflicto armado,18999
24,119,1219,01091,CISNEROS,ANTIOQUIA,1084,1837,2921,63,33,3017,11434,Víctimas de conflicto armado,1587
25,142,1293,01208,REMEDIOS,ANTIOQUIA,1186,2229,3415,126,38,3579,17020,Víctimas de conflicto armado,5061
26,99,1162,01016,AMALFI,ANTIOQUIA,1310,2304,3614,72,132,3818,16928,Víctimas reconocidas Sentencia C280 y Auto 119 de 2013,171
27,100,1163,01016,AMALFI,ANTIOQUIA,1310,2304,3614,72,132,3818,16928,Víctimas de conflicto armado,5004
28,101,1164,01019,ANDES,ANTIOQUIA,3193,5729,8922,93,78,9093,34842,Víctimas reconocidas Sentencia C280 y Auto 119 de 2013,259
29,102,1165,01019,ANDES,ANTIOQUIA,3193,5729,8922,93,78,9093,34842,Víctimas de conflicto armado,3408
30,103,1166,01022,ANGELOPOLIS,ANTIOQUIA,553,1004,1557,23,9,1589,5679,Víctimas reconocidas Sentencia C280 y Auto 119 de 2013,20
31,104,1167,01022,ANGELOPOLIS,ANTIOQUIA,553,1004,1557,23,9,1589,5679,Víctimas de conflicto armado,1256
32,105,1161,01013,AMAGA,ANTIOQUIA,2084,4139,6223,94,53,6370,22028,Víctimas de conflicto armado,1508
33,106,1187,01046,BELMIRA,ANTIOQUIA,687,897,1584,17,16,1617,4807,Víctimas de conflicto armado,442
34,107,1188,01052,BETANIA,ANTIOQUIA,466,1110,1576,22,11,1609,8372,Víctimas reconocidas Sentencia C280 y Auto 119 de 2013,36
35,120,1220,01094,COCORNA,ANTIOQUIA,1647,3006,4653,81,130,4864,12965,Víctimas reconocidas Sentencia C280 y Auto 119 de 2013,198
36,108,1189,01052,BETANIA,ANTIOQUIA,466,1110,1576,22,11,1609,8372,Víctimas de conflicto armado,1710
37,110,1210,01080,CAREPA,ANTIOQUIA,5327,6057,11384,190,159,11733,41461,Víctimas reconocidas Sentencia C280 y Auto 119 de 2013,723
38,111,1211,01080,CAREPA,ANTIOQUIA,5327,6057,11384,190,159,11733,41461,Víctimas de conflicto armado,33589
39,112,1212,01085,CAROLINA,ANTIOQUIA,464,641,1105,23,22,1150,4081,Víctimas reconocidas Sentencia C280 y Auto 119 de 2013,13
40,113,1213,01085,CAROLINA,ANTIOQUIA,464,641,1105,23,22,1150,4081,Víctimas de conflicto armado,435
41,114,1214,01088,CAUCASIA,ANTIOQUIA,8801,11495,20296,368,247,20911,66133,Víctimas reconocidas Sentencia C280 y Auto 119 de 2013,3368
42,115,1208,01079,CARAMANTA,ANTIOQUIA,568,790,1358,26,33,1417,5231,Víctimas reconocidas Sentencia C280 y Auto 119 de 2013,19
43,116,1215,01088,CAUCASIA,ANTIOQUIA,8801,11495,20296,368,247,20911,66133,Víctimas de conflicto armado,17832
44,117,1217,01106,CHIGORODO,ANTIOQUIA,6322,5745,12067,187,138,12392,44791,Víctimas de conflicto armado,43955
45,118,1218,01091,CISNEROS,ANTIOQUIA,1084,1837,2921,63,33,3017,11434,Víctimas reconocidas Sentencia C280 y Auto 119 de 2013,109
46,109,1209,01079,CARAMANTA,ANTIOQUIA,568,790,1358,26,33,1417,5231,Víctimas de conflicto armado,420
47,143,1294,01211,RETIRO,ANTIOQUIA,2145,4703,6848,58,45,6951,15100,Víctimas reconocidas Sentencia C280 y Auto 119 de 2013,30
48,145,1296,01214,RIONEGRO,ANTIOQUIA,14361,32596,46957,637,197,47791,94806,Víctimas reconocidas Sentencia C280 y Auto 119 de 2013,428
49,98,1160,01013,AMAGA,ANTIOQUIA,2084,4139,6223,94,53,6370,22028,Víctimas reconocidas Sentencia C280 y Auto 119 de 2013,80
50,170,1338,01298,YOLOMBO,ANTIOQUIA,1344,2055,3399,57,56,3512,15878,Víctimas reconocidas Sentencia C280 y Auto 119 de 2013,156
51,171,1339,01298,YOLOMBO,ANTIOQUIA,1344,2055,3399,57,56,3512,15878,Víctimas de conflicto armado,4039
52,172,1328,01289,VALPARAISO,ANTIOQUIA,597,893,1490,22,22,1534,5665,Víctimas reconocidas Sentencia C280 y Auto 119 de 2013,21
53,173,1313,01270,TARAZA,ANTIOQUIA,3477,2311,5788,110,90,5988,26186,Víctimas de conflicto armado,15227
54,175,1306,01262,SONSON,ANTIOQUIA,2319,6550,8869,266,158,9293,27198,Víctimas reconocidas Sentencia C280 y Auto 119 de 2013,87
55,176,1305,01259,SEGOVIA,ANTIOQUIA,1516,3073,4589,68,27,4684,26169,Víctimas de conflicto armado,4199
56,177,1307,01262,SONSON,ANTIOQUIA,2319,6550,8869,266,158,9293,27198,Víctimas de conflicto armado,14186
57,178,1308,01265,SOPETRAN,ANTIOQUIA,1875,2266,4141,60,58,4259,12063,Víctimas reconocidas Sentencia C280 y Auto 119 de 2013,21
58,179,1309,01265,SOPETRAN,ANTIOQUIA,1875,2266,4141,60,58,4259,12063,Víctimas de conflicto armado,1009
59,169,1337,01295,YARUMAL,ANTIOQUIA,2941,6091,9032,187,264,9483,33092,Víctimas de conflicto armado,8743
60,180,1310,01268,TAMESIS,ANTIOQUIA,1579,2889,4468,52,59,4579,14473,Víctimas reconocidas Sentencia C280 y Auto 119 de 2013,31
61,182,1302,01220,SALGAR,ANTIOQUIA,782,1621,2403,24,47,2474,13483,Víctimas reconocidas Sentencia C280 y Auto 119 de 2013,73
62,183,1301,01218,SABANETA,ANTIOQUIA,9955,16903,26858,285,39,27182,59616,Víctimas de conflicto armado,2321
63,184,1300,01218,SABANETA,ANTIOQUIA,9955,16903,26858,285,39,27182,59616,Víctimas reconocidas Sentencia C280 y Auto 119 de 2013,257
64,185,1299,01217,SABANALARGA,ANTIOQUIA,778,1501,2279,41,44,2364,7052,Víctimas de conflicto armado,4705
65,186,1298,01217,SABANALARGA,ANTIOQUIA,778,1501,2279,41,44,2364,7052,Víctimas reconocidas Sentencia C280 y Auto 119 de 2013,110
66,187,1297,01214,RIONEGRO,ANTIOQUIA,14361,32596,46957,637,197,47791,94806,Víctimas de conflicto armado,14518
67,188,1304,01259,SEGOVIA,ANTIOQUIA,1516,3073,4589,68,27,4684,26169,Víctimas reconocidas Sentencia C280 y Auto 119 de 2013,212
68,189,1303,01220,SALGAR,ANTIOQUIA,782,1621,2403,24,47,2474,13483,Víctimas de conflicto armado,3755
69,190,1312,01270,TARAZA,ANTIOQUIA,3477,2311,5788,110,90,5988,26186,Víctimas reconocidas Sentencia C280 y Auto 119 de 2013,526
70,181,1311,01268,TAMESIS,ANTIOQUIA,1579,2889,4468,52,59,4579,14473,Víctimas de conflicto armado,808
71,144,1279,01190,NARIÑO,ANTIOQUIA,786,1626,2412,31,70,2513,9015,Víctimas de conflicto armado,9456
72,168,1336,01295,YARUMAL,ANTIOQUIA,2941,6091,9032,187,264,9483,33092,Víctimas reconocidas Sentencia C280 y Auto 119 de 2013,535
73,166,1340,01301,ZARAGOZA,ANTIOQUIA,1672,1726,3398,88,59,3545,18939,Víctimas reconocidas Sentencia C280 y Auto 119 de 2013,593
74,146,1315,01271,TARSO,ANTIOQUIA,503,691,1194,14,22,1230,5883,Víctimas de conflicto armado,278
75,147,1316,01274,TITIRIBI,ANTIOQUIA,742,1362,2104,39,37,2180,8726,Víctimas reconocidas Sentencia C280 y Auto 119 de 2013,24
76,148,1317,01274,TITIRIBI,ANTIOQUIA,742,1362,2104,39,37,2180,8726,Víctimas de conflicto armado,539
77,149,1318,01277,TOLEDO,ANTIOQUIA,798,507,1305,63,61,1429,4383,Víctimas reconocidas Sentencia C280 y Auto 119 de 2013,16
78,150,1319,01277,TOLEDO,ANTIOQUIA,798,507,1305,63,61,1429,4383,Víctimas de conflicto armado,2188
79,151,1295,01211,RETIRO,ANTIOQUIA,2145,4703,6848,58,45,6951,15100,Víctimas de conflicto armado,2154
80,152,1321,01280,TURBO,ANTIOQUIA,11378,8887,20265,371,277,20913,84866,Víctimas de conflicto armado,83560
81,153,1322,01282,URAMITA,ANTIOQUIA,951,813,1764,37,24,1825,6351,Víctimas reconocidas Sentencia C280 y Auto 119 de 2013,157
82,154,1323,01282,URAMITA,ANTIOQUIA,951,813,1764,37,24,1825,6351,Víctimas de conflicto armado,5073
83,167,1335,01293,YALI,ANTIOQUIA,437,692,1129,6,25,1160,6006,Víctimas de conflicto armado,688
84,155,1324,01283,URRAO,ANTIOQUIA,2644,2959,5603,138,123,5864,22361,Víctimas reconocidas Sentencia C280 y Auto 119 de 2013,291
85,157,1326,01286,VALDIVIA,ANTIOQUIA,1072,1069,2141,57,63,2261,12054,Víctimas reconocidas Sentencia C280 y Auto 119 de 2013,200
86,158,1314,01271,TARSO,ANTIOQUIA,503,691,1194,14,22,1230,5883,Víctimas reconocidas Sentencia C280 y Auto 119 de 2013,17
87,159,1327,01286,VALDIVIA,ANTIOQUIA,1072,1069,2141,57,63,2261,12054,Víctimas de conflicto armado,4674
88,160,1329,01289,VALPARAISO,ANTIOQUIA,597,893,1490,22,22,1534,5665,Víctimas de conflicto armado,484
89,161,1330,01290,VEGACHI,ANTIOQUIA,503,1268,1771,22,44,1837,10165,Víctimas reconocidas Sentencia C280 y Auto 119 de 2013,212
90,162,1331,01290,VEGACHI,ANTIOQUIA,503,1268,1771,22,44,1837,10165,Víctimas de conflicto armado,2559
91,163,1332,01292,VENECIA,ANTIOQUIA,1097,1767,2864,26,26,2916,10977,Víctimas reconocidas Sentencia C280 y Auto 119 de 2013,35
92,164,1333,01292,VENECIA,ANTIOQUIA,1097,1767,2864,26,26,2916,10977,Víctimas de conflicto armado,755
93,165,1334,01293,YALI,ANTIOQUIA,437,692,1129,6,25,1160,6006,Víctimas reconocidas Sentencia C280 y Auto 119 de 2013,16
94,156,1325,01283,URRAO,ANTIOQUIA,2644,2959,5603,138,123,5864,22361,Víctimas de conflicto armado,28213
95,97,1169,01025,ANGOSTURA,ANTIOQUIA,705,1089,1794,84,57,1935,9154,Víctimas de conflicto armado,2652
96,174,1320,01280,TURBO,ANTIOQUIA,11378,8887,20265,371,277,20913,84866,Víctimas reconocidas Sentencia C280 y Auto 119 de 2013,1680
97,95,1158,01010,ALEJANDRIA,ANTIOQUIA,966,696,1662,22,51,1735,4577,Víctimas reconocidas Sentencia C280 y Auto 119 de 2013,67
98,26,1231,01115,EBEJICO,ANTIOQUIA,967,1788,2755,32,59,2846,11421,Víctimas de conflicto armado,233
99,27,1230,01115,EBEJICO,ANTIOQUIA,967,1788,2755,32,59,2846,11421,Víctimas reconocidas Sentencia C280 y Auto 119 de 2013,6
100,28,1229,01109,DABEIBA,ANTIOQUIA,2971,1622,4593,99,166,4858,16986,Víctimas de conflicto armado,17489
101,29,1228,01109,DABEIBA,ANTIOQUIA,2971,1622,4593,99,166,4858,16986,Víctimas reconocidas Sentencia C280 y Auto 119 de 2013,161
102,30,1227,01103,COPACABANA,ANTIOQUIA,9535,15052,24587,369,323,25279,62062,Víctimas de conflicto armado,3904
103,31,1226,01103,COPACABANA,ANTIOQUIA,9535,15052,24587,369,323,25279,62062,Víctimas reconocidas Sentencia C280 y Auto 119 de 2013,455
104,32,1225,01100,CONCORDIA,ANTIOQUIA,998,2081,3079,50,55,3184,16027,Víctimas de conflicto armado,2423
105,33,1224,01100,CONCORDIA,ANTIOQUIA,998,2081,3079,50,55,3184,16027,Víctimas reconocidas Sentencia C280 y Auto 119 de 2013,49
106,34,1238,01127,FRONTINO,ANTIOQUIA,2148,1744,3892,78,68,4038,16785,Víctimas reconocidas Sentencia C280 y Auto 119 de 2013,109
107,25,1232,01118,ENTRERRIOS,ANTIOQUIA,868,1766,2634,30,16,2680,7957,Víctimas reconocidas Sentencia C280 y Auto 119 de 2013,21
108,35,1255,01150,HISPANIA,ANTIOQUIA,459,654,1113,11,18,1142,5219,Víctimas de conflicto armado,400
109,38,1289,01199,PEQUE,ANTIOQUIA,1632,608,2240,43,48,2331,6089,Víctimas de conflicto armado,10475
110,39,1288,01199,PEQUE,ANTIOQUIA,1632,608,2240,43,48,2331,6089,Víctimas reconocidas Sentencia C280 y Auto 119 de 2013,8
111,40,1287,01196,PEÑOL,ANTIOQUIA,2032,3265,5297,55,63,5415,15806,Víctimas de conflicto armado,4626
112,41,1286,01196,PEÑOL,ANTIOQUIA,2032,3265,5297,55,63,5415,15806,Víctimas reconocidas Sentencia C280 y Auto 119 de 2013,76
113,42,1285,01193,OLAYA,ANTIOQUIA,273,449,722,7,11,740,2719,Víctimas de conflicto armado,430
114,43,1284,01193,OLAYA,ANTIOQUIA,273,449,722,7,11,740,2719,Víctimas reconocidas Sentencia C280 y Auto 119 de 2013,16
115,44,1283,01192,NECOCLI,ANTIOQUIA,4359,2860,7219,155,101,7475,32486,Víctimas de conflicto armado,34232
116,45,1282,01192,NECOCLI,ANTIOQUIA,4359,2860,7219,155,101,7475,32486,Víctimas reconocidas Sentencia C280 y Auto 119 de 2013,271
117,46,1281,01191,NECHI,ANTIOQUIA,1937,1799,3736,57,41,3834,18186,Víctimas de conflicto armado,7025
118,37,1292,01208,REMEDIOS,ANTIOQUIA,1186,2229,3415,126,38,3579,17020,Víctimas reconocidas Sentencia C280 y Auto 119 de 2013,333
119,47,1280,01191,NECHI,ANTIOQUIA,1937,1799,3736,57,41,3834,18186,Víctimas reconocidas Sentencia C280 y Auto 119 de 2013,864
120,24,1233,01118,ENTRERRIOS,ANTIOQUIA,868,1766,2634,30,16,2680,7957,Víctimas de conflicto armado,293
121,22,1235,01121,ENVIGADO,ANTIOQUIA,37800,67255,105055,1061,872,106988,232003,Víctimas de conflicto armado,4996
122,96,1159,01010,ALEJANDRIA,ANTIOQUIA,966,696,1662,22,51,1735,4577,Víctimas de conflicto armado,5052
123,3,1290,01202,PUEBLORRICO,ANTIOQUIA,593,1138,1731,24,32,1787,7113,Víctimas reconocidas Sentencia C280 y Auto 119 de 2013,19
124,4,1253,01148,HELICONIA,ANTIOQUIA,632,795,1427,29,36,1492,6157,Víctimas de conflicto armado,1167
125,5,1252,01148,HELICONIA,ANTIOQUIA,632,795,1427,29,36,1492,6157,Víctimas reconocidas Sentencia C280 y Auto 119 de 2013,65
126,6,1251,01145,GUATAPE,ANTIOQUIA,1232,1966,3198,37,26,3261,6523,Víctimas de conflicto armado,2473
127,7,1250,01145,GUATAPE,ANTIOQUIA,1232,1966,3198,37,26,3261,6523,Víctimas reconocidas Sentencia C280 y Auto 119 de 2013,76
128,8,1249,01142,GUARNE,ANTIOQUIA,3870,10604,14474,214,116,14804,31687,Víctimas de conflicto armado,3348
129,9,1248,01142,GUARNE,ANTIOQUIA,3870,10604,14474,214,116,14804,31687,Víctimas reconocidas Sentencia C280 y Auto 119 de 2013,223
130,10,1247,01140,GUADALUPE,ANTIOQUIA,714,587,1301,47,40,1388,5656,Víctimas de conflicto armado,591
131,23,1234,01121,ENVIGADO,ANTIOQUIA,37800,67255,105055,1061,872,106988,232003,Víctimas reconocidas Sentencia C280 y Auto 119 de 2013,412
132,11,1246,01140,GUADALUPE,ANTIOQUIA,714,587,1301,47,40,1388,5656,Víctimas reconocidas Sentencia C280 y Auto 119 de 2013,29
133,13,1244,01139,GRANADA,ANTIOQUIA,1382,2120,3502,53,75,3630,10270,Víctimas reconocidas Sentencia C280 y Auto 119 de 2013,95
134,14,1243,01133,GIRARDOTA,ANTIOQUIA,6088,10680,16768,277,90,17135,47612,Víctimas de conflicto armado,2149
135,15,1242,01133,GIRARDOTA,ANTIOQUIA,6088,10680,16768,277,90,17135,47612,Víctimas reconocidas Sentencia C280 y Auto 119 de 2013,233
136,16,1241,01130,GIRALDO,ANTIOQUIA,666,557,1223,17,11,1251,3946,Víctimas de conflicto armado,612
137,17,1240,01130,GIRALDO,ANTIOQUIA,666,557,1223,17,11,1251,3946,Víctimas reconocidas Sentencia C280 y Auto 119 de 2013,40
138,18,1254,01150,HISPANIA,ANTIOQUIA,459,654,1113,11,18,1142,5219,Víctimas reconocidas Sentencia C280 y Auto 119 de 2013,6
139,19,1239,01127,FRONTINO,ANTIOQUIA,2148,1744,3892,78,68,4038,16785,Víctimas de conflicto armado,11675
140,20,1237,01124,FREDONIA,ANTIOQUIA,1703,3064,4767,64,27,4858,18196,Víctimas de conflicto armado,907
141,21,1236,01124,FREDONIA,ANTIOQUIA,1703,3064,4767,64,27,4858,18196,Víctimas reconocidas Sentencia C280 y Auto 119 de 2013,52
142,12,1245,01139,GRANADA,ANTIOQUIA,1382,2120,3502,53,75,3630,10270,Víctimas de conflicto armado,21119
143,48,1278,01190,NARIÑO,ANTIOQUIA,786,1626,2412,31,70,2513,9015,Víctimas reconocidas Sentencia C280 y Auto 119 de 2013,85
144,36,1256,01151,ITAGUI,ANTIOQUIA,35166,59627,94793,1344,426,96563,245703,Víctimas reconocidas Sentencia C280 y Auto 119 de 2013,1500
145,50,1276,01187,MUTATA,ANTIOQUIA,1846,1016,2862,49,119,3030,13626,Víctimas reconocidas Sentencia C280 y Auto 119 de 2013,166
146,75,1174,01035,APARTADO,ANTIOQUIA,14195,12936,27131,478,352,27961,89196,Víctimas reconocidas Sentencia C280 y Auto 119 de 2013,2081
147,76,1175,01035,APARTADO,ANTIOQUIA,14195,12936,27131,478,352,27961,89196,Víctimas de conflicto armado,117190
148,77,1176,01037,ARBOLETES,ANTIOQUIA,3691,1937,5628,57,181,5866,21448,Víctimas reconocidas Sentencia C280 y Auto 119 de 2013,235
149,78,1177,01037,ARBOLETES,ANTIOQUIA,3691,1937,5628,57,181,5866,21448,Víctimas de conflicto armado,20625
150,79,1171,01028,ANORI,ANTIOQUIA,1764,953,2717,40,227,2984,11144,Víctimas de conflicto armado,7157
151,80,1178,01039,ARGELIA,ANTIOQUIA,650,1351,2001,23,41,2065,6627,Víctimas reconocidas Sentencia C280 y Auto 119 de 2013,24
152,81,1180,01040,ARMENIA,ANTIOQUIA,301,676,977,26,23,1026,4844,Víctimas reconocidas Sentencia C280 y Auto 119 de 2013,35
153,82,1181,01040,ARMENIA,ANTIOQUIA,301,676,977,26,23,1026,4844,Víctimas de conflicto armado,267
154,49,1277,01187,MUTATA,ANTIOQUIA,1846,1016,2862,49,119,3030,13626,Víctimas de conflicto armado,26205
155,74,1173,01034,ANZA,ANTIOQUIA,363,740,1103,16,31,1150,5715,Víctimas de conflicto armado,3507
156,84,1183,01043,BARBOSA,ANTIOQUIA,4200,8666,12866,277,287,13430,38541,Víctimas de conflicto armado,4765
157,86,1185,01049,BELLO,ANTIOQUIA,43642,76122,119764,1577,509,121850,318411,Víctimas de conflicto armado,41363
158,87,1179,01039,ARGELIA,ANTIOQUIA,650,1351,2001,23,41,2065,6627,Víctimas de conflicto armado,13923
159,88,1186,01046,BELMIRA,ANTIOQUIA,687,897,1584,17,16,1617,4807,Víctimas reconocidas Sentencia C280 y Auto 119 de 2013,14
160,89,1170,01028,ANORI,ANTIOQUIA,1764,953,2717,40,227,2984,11144,Víctimas reconocidas Sentencia C280 y Auto 119 de 2013,57
161,90,1168,01025,ANGOSTURA,ANTIOQUIA,705,1089,1794,84,57,1935,9154,Víctimas reconocidas Sentencia C280 y Auto 119 de 2013,70
162,91,1154,01004,ABEJORRAL,ANTIOQUIA,1296,2105,3401,52,194,3647,15274,Víctimas reconocidas Sentencia C280 y Auto 119 de 2013,9
163,92,1155,01004,ABEJORRAL,ANTIOQUIA,1296,2105,3401,52,194,3647,15274,Víctimas de conflicto armado,4503
164,93,1156,01007,ABRIAQUI,ANTIOQUIA,213,332,545,13,14,572,1938,Víctimas reconocidas Sentencia C280 y Auto 119 de 2013,10
165,94,1157,01007,ABRIAQUI,ANTIOQUIA,213,332,545,13,14,572,1938,Víctimas de conflicto armado,1444
166,85,1184,01049,BELLO,ANTIOQUIA,43642,76122,119764,1577,509,121850,318411,Víctimas reconocidas Sentencia C280 y Auto 119 de 2013,4438
167,73,1172,01034,ANZA,ANTIOQUIA,363,740,1103,16,31,1150,5715,Víctimas reconocidas Sentencia C280 y Auto 119 de 2013,31
168,83,1182,01043,BARBOSA,ANTIOQUIA,4200,8666,12866,277,287,13430,38541,Víctimas reconocidas Sentencia C280 y Auto 119 de 2013,256
169,71,1341,01301,ZARAGOZA,ANTIOQUIA,1672,1726,3398,88,59,3545,18939,Víctimas de conflicto armado,5606
170,72,1223,01097,CONCEPCION,ANTIOQUIA,572,931,1503,27,23,1553,4409,Víctimas de conflicto armado,1956
171,52,1274,01184,MURINDO,ANTIOQUIA,1073,44,1117,14,19,1150,2724,Víctimas reconocidas Sentencia C280 y Auto 119 de 2013,13
172,53,1273,01181,MONTEBELLO,ANTIOQUIA,953,776,1729,35,63,1827,6043,Víctimas de conflicto armado,2249
173,54,1272,01181,MONTEBELLO,ANTIOQUIA,953,776,1729,35,63,1827,6043,Víctimas reconocidas Sentencia C280 y Auto 119 de 2013,9
174,55,1258,01154,ITUANGO,ANTIOQUIA,2706,1196,3902,116,139,4157,17406,Víctimas reconocidas Sentencia C280 y Auto 119 de 2013,85
175,56,1259,01154,ITUANGO,ANTIOQUIA,2706,1196,3902,116,139,4157,17406,Víctimas de conflicto armado,17591
176,57,1260,01157,JARDIN,ANTIOQUIA,1620,2884,4504,44,46,4594,12094,Víctimas reconocidas Sentencia C280 y Auto 119 de 2013,24
177,58,1261,01157,JARDIN,ANTIOQUIA,1620,2884,4504,44,46,4594,12094,Víctimas de conflicto armado,922
178,59,1262,01160,JERICO,ANTIOQUIA,957,2341,3298,39,36,3373,11023,Víctimas reconocidas Sentencia C280 y Auto 119 de 2013,32
179,61,1291,01202,PUEBLORRICO,ANTIOQUIA,593,1138,1731,24,32,1787,7113,Víctimas de conflicto armado,440
180,60,1263,01160,JERICO,ANTIOQUIA,957,2341,3298,39,36,3373,11023,Víctimas de conflicto armado,437
181,63,1266,01175,MACEO,ANTIOQUIA,777,1065,1842,26,31,1899,7467,Víctimas reconocidas Sentencia C280 y Auto 119 de 2013,87
182,64,1267,01175,MACEO,ANTIOQUIA,777,1065,1842,26,31,1899,7467,Víctimas de conflicto armado,2436
183,65,1268,01178,MARINILLA,ANTIOQUIA,5481,11993,17474,190,103,17767,38176,Víctimas reconocidas Sentencia C280 y Auto 119 de 2013,336
184,66,1269,01178,MARINILLA,ANTIOQUIA,5481,11993,17474,190,103,17767,38176,Víctimas de conflicto armado,10224
185,51,1275,01184,MURINDO,ANTIOQUIA,1073,44,1117,14,19,1150,2724,Víctimas de conflicto armado,5076
186,67,1270,01001,MEDELLIN,ANTIOQUIA,253548,431173,684721,6754,3309,694784,1508418,Víctimas reconocidas Sentencia C280 y Auto 119 de 2013,38074
187,68,1271,01001,MEDELLIN,ANTIOQUIA,253548,431173,684721,6754,3309,694784,1508418,Víctimas de conflicto armado,587456
188,69,1265,01172,LIBORINA,ANTIOQUIA,933,1674,2607,40,56,2703,9204,Víctimas de conflicto armado,4463
189,70,1257,01151,ITAGUI,ANTIOQUIA,35166,59627,94793,1344,426,96563,245703,Víctimas de conflicto armado,15662
190,62,1264,01172,LIBORINA,ANTIOQUIA,933,1674,2607,40,56,2703,9204,Víctimas reconocidas Sentencia C280 y Auto 119 de 2013,72
191,200,654,40010,ARAUQUITA,ARAUCA,7440,2289,9729,234,150,10113,27274,Víctimas reconocidas Sentencia C280 y Auto 119 de 2013,309
192,197,659,40025,SARAVENA,ARAUCA,4457,5168,9625,335,131,10091,31702,Víctimas de conflicto armado,15277
193,199,661,40005,TAME,ARAUCA,5407,5267,10674,263,131,11068,31607,Víctimas de conflicto armado,23576
194,198,660,40005,TAME,ARAUCA,5407,5267,10674,263,131,11068,31607,Víctimas reconocidas Sentencia C280 y Auto 119 de 2013,220
195,196,658,40025,SARAVENA,ARAUCA,4457,5168,9625,335,131,10091,31702,Víctimas reconocidas Sentencia C280 y Auto 119 de 2013,118
196,192,653,40001,ARAUCA,ARAUCA,8159,15191,23350,447,139,23936,67929,Víctimas de conflicto armado,38991
197,194,656,40017,FORTUL,ARAUCA,2338,1063,3401,187,58,3646,10912,Víctimas reconocidas Sentencia C280 y Auto 119 de 2013,105
198,193,655,40010,ARAUQUITA,ARAUCA,7440,2289,9729,234,150,10113,27274,Víctimas de conflicto armado,9270
199,191,652,40001,ARAUCA,ARAUCA,8159,15191,23350,447,139,23936,67929,Víctimas reconocidas Sentencia C280 y Auto 119 de 2013,531
200,195,657,40017,FORTUL,ARAUCA,2338,1063,3401,187,58,3646,10912,Víctimas de conflicto armado,6273
201,218,101,03010,CANDELARIA,ATLANTICO,2078,906,2984,25,25,3034,11294,Víctimas de conflicto armado,661
202,219,120,03052,SOLEDAD,ATLANTICO,33765,23487,57252,307,226,57785,264289,Víctimas reconocidas Sentencia C280 y Auto 119 de 2013,1524
203,220,103,03013,GALAPA,ATLANTICO,5186,3176,8362,74,28,8464,34607,Víctimas de conflicto armado,3116
204,221,104,03019,LURUACO,ATLANTICO,2265,1246,3511,25,28,3564,23080,Víctimas reconocidas Sentencia C280 y Auto 119 de 2013,25
205,231,113,03035,PONEDERA,ATLANTICO,2445,1421,3866,20,23,3909,17776,Víctimas de conflicto armado,1439
206,223,106,03022,MALAMBO,ATLANTICO,8810,6908,15718,94,45,15857,74964,Víctimas reconocidas Sentencia C280 y Auto 119 de 2013,273
207,225,108,03025,MANATI,ATLANTICO,1660,317,1977,10,8,1995,13416,Víctimas de conflicto armado,375
208,226,109,03031,PIOJO,ATLANTICO,1118,391,1509,15,13,1537,5409,Víctimas reconocidas Sentencia C280 y Auto 119 de 2013,11
209,227,110,03031,PIOJO,ATLANTICO,1118,391,1509,15,13,1537,5409,Víctimas de conflicto armado,310
210,228,111,03034,POLONUEVO,ATLANTICO,2746,639,3385,29,23,3437,12246,Víctimas de conflicto armado,199
211,229,112,03035,PONEDERA,ATLANTICO,2445,1421,3866,20,23,3909,17776,Víctimas reconocidas Sentencia C280 y Auto 119 de 2013,19
212,230,102,03013,GALAPA,ATLANTICO,5186,3176,8362,74,28,8464,34607,Víctimas reconocidas Sentencia C280 y Auto 119 de 2013,119
213,217,121,03052,SOLEDAD,ATLANTICO,33765,23487,57252,307,226,57785,264289,Víctimas de conflicto armado,41891
214,224,107,03022,MALAMBO,ATLANTICO,8810,6908,15718,94,45,15857,74964,Víctimas de conflicto armado,10541
215,216,115,03040,REPELON,ATLANTICO,3325,829,4154,24,35,4213,18423,Víctimas de conflicto armado,569
216,222,105,03019,LURUACO,ATLANTICO,2265,1246,3511,25,28,3564,23080,Víctimas de conflicto armado,939
217,214,126,03061,USIACURI,ATLANTICO,1677,489,2166,15,14,2195,7497,Víctimas de conflicto armado,71
218,215,100,03010,CANDELARIA,ATLANTICO,2078,906,2984,25,25,3034,11294,Víctimas reconocidas Sentencia C280 y Auto 119 de 2013,14
219,201,118,03046,SABANALARGA,ATLANTICO,12851,4663,17514,142,421,18077,64908,Víctimas reconocidas Sentencia C280 y Auto 119 de 2013,87
220,203,99,03001,BARRANQUILLA,ATLANTICO,146039,108178,254217,1111,1047,256375,1029268,Víctimas de conflicto armado,139221
221,204,97,03004,BARANOA,ATLANTICO,8936,3416,12352,58,139,12549,45824,Víctimas de conflicto armado,1804
222,205,96,03004,BARANOA,ATLANTICO,8936,3416,12352,58,139,12549,45824,Víctimas reconocidas Sentencia C280 y Auto 119 de 2013,97
223,206,116,03043,SABANAGRANDE,ATLANTICO,3251,1835,5086,29,17,5132,22784,Víctimas reconocidas Sentencia C280 y Auto 119 de 2013,189
224,202,98,03001,BARRANQUILLA,ATLANTICO,146039,108178,254217,1111,1047,256375,1029268,Víctimas reconocidas Sentencia C280 y Auto 119 de 2013,3291
225,208,119,03046,SABANALARGA,ATLANTICO,12851,4663,17514,142,421,18077,64908,Víctimas de conflicto armado,3200
226,209,114,03040,REPELON,ATLANTICO,3325,829,4154,24,35,4213,18423,Víctimas reconocidas Sentencia C280 y Auto 119 de 2013,21
227,210,122,03055,SUAN,ATLANTICO,1837,585,2422,3,3,2428,9555,Víctimas reconocidas Sentencia C280 y Auto 119 de 2013,5
228,211,123,03055,SUAN,ATLANTICO,1837,585,2422,3,3,2428,9555,Víctimas de conflicto armado,513
229,212,124,03058,TUBARA,ATLANTICO,1888,898,2786,16,17,2819,9481,Víctimas reconocidas Sentencia C280 y Auto 119 de 2013,8
230,213,125,03058,TUBARA,ATLANTICO,1888,898,2786,16,17,2819,9481,Víctimas de conflicto armado,445
231,207,117,03043,SABANAGRANDE,ATLANTICO,3251,1835,5086,29,17,5132,22784,Víctimas de conflicto armado,4165
232,265,26,05007,ARJONA,BOLIVAR,6030,3642,9672,63,50,9785,51077,Víctimas reconocidas Sentencia C280 y Auto 119 de 2013,90
233,263,28,05013,CALAMAR,BOLIVAR,2140,1490,3630,37,48,3715,17670,Víctimas de conflicto armado,805
234,262,29,05014,CANTAGALLO,BOLIVAR,1878,732,2610,44,17,2671,6076,Víctimas reconocidas Sentencia C280 y Auto 119 de 2013,30
235,261,30,05014,CANTAGALLO,BOLIVAR,1878,732,2610,44,17,2671,6076,Víctimas de conflicto armado,1853
236,258,66,05124,VILLANUEVA,BOLIVAR,1181,763,1944,14,16,1974,15014,Víctimas de conflicto armado,3483
237,259,62,05118,TURBACO,BOLIVAR,5927,3957,9884,41,29,9954,58808,Víctimas de conflicto armado,6148
238,257,60,05106,SOPLAVIENTO,BOLIVAR,1888,324,2212,20,10,2242,7990,Víctimas de conflicto armado,236
239,266,25,05005,ARENAL,BOLIVAR,1690,229,1919,23,8,1950,5625,Víctimas de conflicto armado,5048
240,260,34,05015,CICUCO,BOLIVAR,2082,856,2938,21,29,2988,9346,Víctimas de conflicto armado,633
241,267,24,05005,ARENAL,BOLIVAR,1690,229,1919,23,8,1950,5625,Víctimas reconocidas Sentencia C280 y Auto 119 de 2013,51
242,275,67,05127,ZAMBRANO,BOLIVAR,3140,507,3647,46,34,3727,8695,Víctimas reconocidas Sentencia C280 y Auto 119 de 2013,28
243,269,31,05001,CARTAGENA,BOLIVAR,81500,64735,146235,518,688,147441,732774,Víctimas reconocidas Sentencia C280 y Auto 119 de 2013,3625
244,270,22,05004,ACHI,BOLIVAR,4307,1874,6181,87,61,6329,15748,Víctimas reconocidas Sentencia C280 y Auto 119 de 2013,281
245,271,61,05118,TURBACO,BOLIVAR,5927,3957,9884,41,29,9954,58808,Víctimas reconocidas Sentencia C280 y Auto 119 de 2013,98
246,272,33,05015,CICUCO,BOLIVAR,2082,856,2938,21,29,2988,9346,Víctimas reconocidas Sentencia C280 y Auto 119 de 2013,36
247,273,32,05001,CARTAGENA,BOLIVAR,81500,64735,146235,518,688,147441,732774,Víctimas de conflicto armado,119232
248,274,68,05127,ZAMBRANO,BOLIVAR,3140,507,3647,46,34,3727,8695,Víctimas de conflicto armado,9345
249,256,47,05041,MONTECRISTO,BOLIVAR,1652,395,2047,17,35,2099,8357,Víctimas reconocidas Sentencia C280 y Auto 119 de 2013,108
250,276,65,05124,VILLANUEVA,BOLIVAR,1181,763,1944,14,16,1974,15014,Víctimas reconocidas Sentencia C280 y Auto 119 de 2013,24
251,277,64,05121,TURBANA,BOLIVAR,1728,781,2509,17,17,2543,13769,Víctimas de conflicto armado,300
252,278,63,05121,TURBANA,BOLIVAR,1728,781,2509,17,17,2543,13769,Víctimas reconocidas Sentencia C280 y Auto 119 de 2013,8
253,268,23,05004,ACHI,BOLIVAR,4307,1874,6181,87,61,6329,15748,Víctimas de conflicto armado,4108
254,255,35,05018,CLEMENCIA,BOLIVAR,1146,590,1736,17,19,1772,10304,Víctimas reconocidas Sentencia C280 y Auto 119 de 2013,16
255,264,27,05007,ARJONA,BOLIVAR,6030,3642,9672,63,50,9785,51077,Víctimas de conflicto armado,6532
256,253,37,05016,CORDOBA,BOLIVAR,3612,1001,4613,43,66,4722,13053,Víctimas reconocidas Sentencia C280 y Auto 119 de 2013,43
257,254,36,05018,CLEMENCIA,BOLIVAR,1146,590,1736,17,19,1772,10304,Víctimas de conflicto armado,1330
258,232,50,05044,MORALES,BOLIVAR,1936,2206,4142,39,34,4215,10842,Víctimas de conflicto armado,7034
259,233,51,05050,NOROSI,BOLIVAR,969,177,1146,14,9,1169,3698,Víctimas reconocidas Sentencia C280 y Auto 119 de 2013,9
260,234,52,05050,NOROSI,BOLIVAR,969,177,1146,14,9,1169,3698,Víctimas de conflicto armado,4749
261,236,57,05097,SIMITI,BOLIVAR,1753,1783,3536,73,43,3652,11953,Víctimas reconocidas Sentencia C280 y Auto 119 de 2013,108
262,237,55,05063,REGIDOR,BOLIVAR,1092,323,1415,18,4,1437,4492,Víctimas reconocidas Sentencia C280 y Auto 119 de 2013,46
263,238,56,05063,REGIDOR,BOLIVAR,1092,323,1415,18,4,1437,4492,Víctimas de conflicto armado,2917
264,239,49,05044,MORALES,BOLIVAR,1936,2206,4142,39,34,4215,10842,Víctimas reconocidas Sentencia C280 y Auto 119 de 2013,40
265,240,58,05097,SIMITI,BOLIVAR,1753,1783,3536,73,43,3652,11953,Víctimas de conflicto armado,7259
266,241,54,05059,PINILLOS,BOLIVAR,2973,1885,4858,41,49,4948,16205,Víctimas de conflicto armado,2176
267,242,48,05041,MONTECRISTO,BOLIVAR,1652,395,2047,17,35,2099,8357,Víctimas de conflicto armado,9530
268,235,53,05059,PINILLOS,BOLIVAR,2973,1885,4858,41,49,4948,16205,Víctimas reconocidas Sentencia C280 y Auto 119 de 2013,133
269,244,46,05043,MOMPOS,BOLIVAR,5198,3036,8234,68,59,8361,34934,Víctimas de conflicto armado,1132
270,243,43,05037,MARGARITA,BOLIVAR,1361,919,2280,13,33,2326,8814,Víctimas reconocidas Sentencia C280 y Auto 119 de 2013,11
271,251,39,05028,MAGANGUE,BOLIVAR,16478,9966,26444,261,206,26911,93554,Víctimas reconocidas Sentencia C280 y Auto 119 de 2013,2299
272,252,38,05016,CORDOBA,BOLIVAR,3612,1001,4613,43,66,4722,13053,Víctimas de conflicto armado,14233
273,249,41,05031,MAHATES,BOLIVAR,2819,1222,4041,32,48,4121,19421,Víctimas reconocidas Sentencia C280 y Auto 119 de 2013,50
274,250,40,05028,MAGANGUE,BOLIVAR,16478,9966,26444,261,206,26911,93554,Víctimas de conflicto armado,40268
275,247,59,05106,SOPLAVIENTO,BOLIVAR,1888,324,2212,20,10,2242,7990,Víctimas reconocidas Sentencia C280 y Auto 119 de 2013,6
276,246,44,05037,MARGARITA,BOLIVAR,1361,919,2280,13,33,2326,8814,Víctimas de conflicto armado,312
277,245,45,05043,MOMPOS,BOLIVAR,5198,3036,8234,68,59,8361,34934,Víctimas reconocidas Sentencia C280 y Auto 119 de 2013,28
278,248,42,05031,MAHATES,BOLIVAR,2819,1222,4041,32,48,4121,19421,Víctimas de conflicto armado,5150
279,371,1133,07301,TENZA,BOYACA,1028,592,1620,26,17,1663,3555,Víctimas de conflicto armado,15
280,370,1132,07298,TASCO,BOYACA,913,641,1554,37,7,1598,4986,Víctimas de conflicto armado,131
281,372,1134,07304,TIBANA,BOYACA,1312,740,2052,57,14,2123,7402,Víctimas de conflicto armado,16
282,373,1135,07307,TIBASOSA,BOYACA,1842,1685,3527,75,13,3615,8412,Víctimas de conflicto armado,247
283,374,1136,07310,TINJACA,BOYACA,632,505,1137,20,5,1162,2538,Víctimas de conflicto armado,14
284,375,1137,07311,TIPACOQUE,BOYACA,557,520,1077,29,30,1136,3353,Víctimas de conflicto armado,19
285,376,1138,07313,TOCA,BOYACA,1107,1168,2275,40,29,2344,6996,Víctimas reconocidas Sentencia C280 y Auto 119 de 2013,3
286,380,1131,07298,TASCO,BOYACA,913,641,1554,37,7,1598,4986,Víctimas reconocidas Sentencia C280 y Auto 119 de 2013,1
287,378,1140,07316,TOGUI,BOYACA,516,410,926,22,19,967,4284,Víctimas de conflicto armado,71
288,379,1141,07319,TOPAGA,BOYACA,552,789,1341,19,10,1370,2924,Víctimas de conflicto armado,71
289,381,1142,07322,TOTA,BOYACA,318,590,908,25,10,943,4105,Víctimas de conflicto armado,17
290,382,1144,07001,TUNJA,BOYACA,32780,25112,57892,1003,143,59038,116576,Víctimas de conflicto armado,9317
291,369,1104,07223,RONDON,BOYACA,469,426,895,17,17,929,2283,Víctimas de conflicto armado,59
292,383,1145,07324,TUNUNGUA,BOYACA,461,181,642,9,4,655,1314,Víctimas de conflicto armado,6
293,377,1139,07313,TOCA,BOYACA,1107,1168,2275,40,29,2344,6996,Víctimas de conflicto armado,54
294,368,1065,07121,JENESANO,BOYACA,1031,584,1615,33,25,1673,5464,Víctimas de conflicto armado,79
295,356,1045,07055,CORRALES,BOYACA,408,511,919,22,14,955,2228,Víctimas de conflicto armado,2
296,366,1034,07067,CHIQUINQUIRA,BOYACA,8110,8619,16729,303,87,17119,40893,Víctimas de conflicto armado,1593
297,384,1146,07325,TURMEQUE,BOYACA,1161,568,1729,41,16,1786,5703,Víctimas de conflicto armado,14
298,352,1049,07060,CUCAITA,BOYACA,683,543,1226,30,8,1264,3186,Víctimas de conflicto armado,8
299,353,1048,07059,CUBARA,BOYACA,781,597,1378,68,23,1469,5484,Víctimas de conflicto armado,999
300,354,1047,07058,COVARACHIA,BOYACA,394,626,1020,16,44,1080,3133,Víctimas de conflicto armado,65
301,351,1050,07061,CUITIVA,BOYACA,269,363,632,19,2,653,1851,Víctimas de conflicto armado,89
302,355,1046,07058,COVARACHIA,BOYACA,394,626,1020,16,44,1080,3133,Víctimas reconocidas Sentencia C280 y Auto 119 de 2013,3
303,367,1102,07217,RAMIRIQUI,BOYACA,1466,1267,2733,34,22,2789,8601,Víctimas de conflicto armado,187
304,357,1044,07052,COPER,BOYACA,779,521,1300,19,13,1332,3278,Víctimas de conflicto armado,65
305,359,1042,07049,COMBITA,BOYACA,2081,1452,3533,86,34,3653,8585,Víctimas reconocidas Sentencia C280 y Auto 119 de 2013,3
306,360,1041,07046,CIENEGA,BOYACA,543,655,1198,16,19,1233,3872,Víctimas de conflicto armado,19
307,361,1040,07078,CHIVOR,BOYACA,260,378,638,8,10,656,1769,Víctimas de conflicto armado,149
308,362,1039,07077,CHIVATA,BOYACA,477,439,916,7,7,930,2542,Víctimas de conflicto armado,14
309,363,1038,07076,CHITARAQUE,BOYACA,644,962,1606,19,29,1654,5445,Víctimas de conflicto armado,206
310,364,1037,07073,CHITA,BOYACA,861,1294,2155,75,89,2319,6331,Víctimas de conflicto armado,396
311,358,1043,07049,COMBITA,BOYACA,2081,1452,3533,86,34,3653,8585,Víctimas de conflicto armado,63
312,385,1147,07328,TUTA,BOYACA,1536,1497,3033,57,23,3113,7216,Víctimas de conflicto armado,42
313,416,1120,07280,SOMONDOCO,BOYACA,529,344,873,14,8,895,2779,Víctimas reconocidas Sentencia C280 y Auto 119 de 2013,6
314,387,1149,07334,UMBITA,BOYACA,980,1224,2204,47,30,2281,5815,Víctimas de conflicto armado,17
315,406,1115,07268,SOATA,BOYACA,1461,1989,3450,56,37,3543,7449,Víctimas de conflicto armado,66
316,407,1116,07274,SOCHA,BOYACA,1138,1160,2298,64,33,2395,6151,Víctimas de conflicto armado,324
317,408,1107,07235,SAMACA,BOYACA,2343,2340,4683,130,36,4849,13405,Víctimas reconocidas Sentencia C280 y Auto 119 de 2013,32
318,409,1126,07286,SUSACON,BOYACA,701,410,1111,36,19,1166,2580,Víctimas reconocidas Sentencia C280 y Auto 119 de 2013,4
319,410,1117,07271,SOCOTA,BOYACA,791,1214,2005,60,39,2104,5922,Víctimas de conflicto armado,113
320,411,1125,07283,SOTAQUIRA,BOYACA,1039,978,2017,39,14,2070,5413,Víctimas de conflicto armado,50
321,405,1114,07265,SIACHOQUE,BOYACA,778,1453,2231,54,25,2310,6256,Víctimas de conflicto armado,4
322,412,1124,07282,SORACA,BOYACA,740,1489,2229,24,20,2273,5229,Víctimas de conflicto armado,24
323,414,1127,07286,SUSACON,BOYACA,701,410,1111,36,19,1166,2580,Víctimas de conflicto armado,34
324,415,1121,07280,SOMONDOCO,BOYACA,529,344,873,14,8,895,2779,Víctimas de conflicto armado,99
325,417,1119,07277,SOGAMOSO,BOYACA,20261,20865,41126,700,148,41974,89443,Víctimas de conflicto armado,3791
326,418,1118,07277,SOGAMOSO,BOYACA,20261,20865,41126,700,148,41974,89443,Víctimas reconocidas Sentencia C280 y Auto 119 de 2013,58
327,419,1122,07281,SORA,BOYACA,686,459,1145,22,152,1319,2528,Víctimas de conflicto armado,5
328,350,1051,07079,DUITAMA,BOYACA,19535,20787,40322,770,119,41211,83354,Víctimas reconocidas Sentencia C280 y Auto 119 de 2013,73
329,413,1123,07282,SORACA,BOYACA,740,1489,2229,24,20,2273,5229,Víctimas reconocidas Sentencia C280 y Auto 119 de 2013,5
330,386,1148,07331,TUTAZA,BOYACA,492,412,904,29,16,949,1841,Víctimas de conflicto armado,20
331,404,1113,07262,SATIVASUR,BOYACA,197,174,371,4,2,377,1227,Víctimas de conflicto armado,11
332,402,1111,07259,SATIVANORTE,BOYACA,373,362,735,23,15,773,2398,Víctimas reconocidas Sentencia C280 y Auto 119 de 2013,3
333,388,1150,07337,VENTAQUEMADA,BOYACA,1566,1689,3255,81,18,3354,10912,Víctimas de conflicto armado,42
334,389,1152,07346,ZETAQUIRA,BOYACA,910,473,1383,15,12,1410,3874,Víctimas reconocidas Sentencia C280 y Auto 119 de 2013,8
335,390,1153,07346,ZETAQUIRA,BOYACA,910,473,1383,15,12,1410,3874,Víctimas de conflicto armado,251
336,391,1103,07220,RAQUIRA,BOYACA,815,851,1666,44,20,1730,4570,Víctimas de conflicto armado,32
337,392,1143,07001,TUNJA,BOYACA,32780,25112,57892,1003,143,59038,116576,Víctimas reconocidas Sentencia C280 y Auto 119 de 2013,143
338,393,1130,07292,SUTATENZA,BOYACA,612,662,1274,30,14,1318,3682,Víctimas de conflicto armado,87
339,403,1112,07259,SATIVANORTE,BOYACA,373,362,735,23,15,773,2398,Víctimas de conflicto armado,74
340,394,1151,07340,VIRACACHA,BOYACA,343,452,795,16,11,822,2553,Víctimas de conflicto armado,21
341,396,1129,07289,SUTAMARCHAN,BOYACA,1132,931,2063,38,18,2119,5264,Víctimas de conflicto armado,57
342,397,1105,07226,SABOYA,BOYACA,2246,1250,3496,112,56,3664,9555,Víctimas de conflicto armado,32
343,398,1106,07232,SACHICA,BOYACA,702,624,1326,13,11,1350,3320,Víctimas de conflicto armado,28
344,399,1108,07235,SAMACA,BOYACA,2343,2340,4683,130,36,4849,13405,Víctimas de conflicto armado,649
345,400,1109,07250,SANTANA,BOYACA,1106,1034,2140,34,24,2198,6831,Víctimas reconocidas Sentencia C280 y Auto 119 de 2013,3
346,401,1110,07250,SANTANA,BOYACA,1106,1034,2140,34,24,2198,6831,Víctimas de conflicto armado,153
347,395,1128,07289,SUTAMARCHAN,BOYACA,1132,931,2063,38,18,2119,5264,Víctimas reconocidas Sentencia C280 y Auto 119 de 2013,8
348,349,1052,07079,DUITAMA,BOYACA,19535,20787,40322,770,119,41211,83354,Víctimas de conflicto armado,2833
349,365,1036,07070,CHISCAS,BOYACA,672,658,1330,40,35,1405,3519,Víctimas de conflicto armado,306
350,347,1054,07091,FLORESTA,BOYACA,527,799,1326,20,8,1354,3078,Víctimas de conflicto armado,22
351,297,1089,07179,PAEZ,BOYACA,558,613,1171,43,14,1228,2338,Víctimas de conflicto armado,1186
352,298,1090,07181,PAIPA,BOYACA,6187,4866,11053,200,59,11312,24543,Víctimas reconocidas Sentencia C280 y Auto 119 de 2013,26
353,299,1091,07181,PAIPA,BOYACA,6187,4866,11053,200,59,11312,24543,Víctimas de conflicto armado,728
354,300,1092,07184,PAJARITO,BOYACA,234,399,633,9,8,650,1713,Víctimas reconocidas Sentencia C280 y Auto 119 de 2013,1
355,301,1093,07184,PAJARITO,BOYACA,234,399,633,9,8,650,1713,Víctimas de conflicto armado,1384
356,303,1095,07190,PAUNA,BOYACA,1521,802,2323,41,37,2401,6712,Víctimas reconocidas Sentencia C280 y Auto 119 de 2013,18
357,296,1088,07179,PAEZ,BOYACA,558,613,1171,43,14,1228,2338,Víctimas reconocidas Sentencia C280 y Auto 119 de 2013,3
358,304,1078,07161,MOTAVITA,BOYACA,955,836,1791,41,14,1846,4938,Víctimas de conflicto armado,24
359,306,1061,07106,GUATEQUE,BOYACA,1718,1599,3317,80,24,3421,8954,Víctimas de conflicto armado,287
360,307,1062,07109,GUAYATA,BOYACA,861,633,1494,22,14,1530,3849,Víctimas de conflicto armado,99
361,308,1063,07112,GUICAN,BOYACA,556,592,1148,42,14,1204,3033,Víctimas de conflicto armado,55
362,309,1064,07118,IZA,BOYACA,367,465,832,13,12,857,2224,Víctimas de conflicto armado,5
363,310,1066,07124,JERICO,BOYACA,359,570,929,23,22,974,3218,Víctimas de conflicto armado,14
364,311,1067,07127,LABRANZAGRANDE,BOYACA,444,529,973,17,13,1003,2722,Víctimas de conflicto armado,348
365,305,1076,07160,MONIQUIRA,BOYACA,3257,3016,6273,162,57,6492,17452,Víctimas reconocidas Sentencia C280 y Auto 119 de 2013,2
366,312,1077,07160,MONIQUIRA,BOYACA,3257,3016,6273,162,57,6492,17452,Víctimas de conflicto armado,398
367,295,1086,07176,OTANCHE,BOYACA,1021,1297,2318,28,23,2369,6406,Víctimas de conflicto armado,646
368,293,1085,07176,OTANCHE,BOYACA,1021,1297,2318,28,23,2369,6406,Víctimas reconocidas Sentencia C280 y Auto 119 de 2013,6
369,279,1098,07202,PESCA,BOYACA,710,1061,1771,33,15,1819,6418,Víctimas reconocidas Sentencia C280 y Auto 119 de 2013,1
370,280,1099,07202,PESCA,BOYACA,710,1061,1771,33,15,1819,6418,Víctimas de conflicto armado,82
371,281,1100,07205,PISBA,BOYACA,195,256,451,3,9,463,1021,Víctimas de conflicto armado,62
372,282,1060,07106,GUATEQUE,BOYACA,1718,1599,3317,80,24,3421,8954,Víctimas reconocidas Sentencia C280 y Auto 119 de 2013,6
373,283,1059,07103,GUACAMAYAS,BOYACA,122,479,601,19,11,631,1656,Víctimas de conflicto armado,15
374,284,1097,07193,PAYA,BOYACA,320,383,703,26,8,737,1406,Víctimas de conflicto armado,106
375,294,1079,07163,MUZO,BOYACA,858,1470,2328,55,37,2420,7195,Víctimas reconocidas Sentencia C280 y Auto 119 de 2013,1
376,285,1096,07190,PAUNA,BOYACA,1521,802,2323,41,37,2401,6712,Víctimas de conflicto armado,653
377,287,1058,07100,GARAGOA,BOYACA,2534,2485,5019,119,36,5174,11845,Víctimas de conflicto armado,513
378,288,1080,07163,MUZO,BOYACA,858,1470,2328,55,37,2420,7195,Víctimas de conflicto armado,293
379,289,1081,07166,NOBSA,BOYACA,2835,2809,5644,86,11,5741,11546,Víctimas reconocidas Sentencia C280 y Auto 119 de 2013,9
380,290,1082,07166,NOBSA,BOYACA,2835,2809,5644,86,11,5741,11546,Víctimas de conflicto armado,333
381,291,1083,07173,OICATA,BOYACA,605,492,1097,30,8,1135,2392,Víctimas reconocidas Sentencia C280 y Auto 119 de 2013,4
382,292,1084,07173,OICATA,BOYACA,605,492,1097,30,8,1135,2392,Víctimas de conflicto armado,5
383,286,1094,07187,PANQUEBA,BOYACA,285,335,620,15,14,649,1605,Víctimas de conflicto armado,4
384,313,1068,07142,MACANAL,BOYACA,464,728,1192,24,19,1235,3603,Víctimas reconocidas Sentencia C280 y Auto 119 de 2013,10
385,302,1087,07178,PACHAVITA,BOYACA,370,374,744,15,20,779,2001,Víctimas de conflicto armado,45
386,315,1071,07148,MARIPI,BOYACA,1371,459,1830,25,16,1871,6271,Víctimas de conflicto armado,97
387,333,1022,07022,BOAVITA,BOYACA,798,1002,1800,40,26,1866,5162,Víctimas reconocidas Sentencia C280 y Auto 119 de 2013,4
388,334,1021,07019,BETEITIVA,BOYACA,407,252,659,19,7,685,1915,Víctimas de conflicto armado,18
389,335,1020,07019,BETEITIVA,BOYACA,407,252,659,19,7,685,1915,Víctimas reconocidas Sentencia C280 y Auto 119 de 2013,6
390,336,1019,07016,BERBEO,BOYACA,387,181,568,15,5,588,1465,Víctimas de conflicto armado,156
391,337,1018,07016,BERBEO,BOYACA,387,181,568,15,5,588,1465,Víctimas reconocidas Sentencia C280 y Auto 119 de 2013,2
392,338,1017,07013,BELEN,BOYACA,1150,1344,2494,81,27,2602,6748,Víctimas de conflicto armado,149
393,348,1053,07088,FIRAVITOBA,BOYACA,1317,758,2075,37,17,2129,5680,Víctimas de conflicto armado,53
394,339,1016,07013,BELEN,BOYACA,1150,1344,2494,81,27,2602,6748,Víctimas reconocidas Sentencia C280 y Auto 119 de 2013,9
395,314,1070,07148,MARIPI,BOYACA,1371,459,1830,25,16,1871,6271,Víctimas reconocidas Sentencia C280 y Auto 119 de 2013,3
396,342,1013,07007,ALMEIDA,BOYACA,348,327,675,11,7,693,1908,Víctimas de conflicto armado,18
397,343,1032,07064,CHINAVITA,BOYACA,421,497,918,17,7,942,3131,Víctimas de conflicto armado,123
398,344,1056,07097,GAMEZA,BOYACA,621,825,1446,23,22,1491,4056,Víctimas de conflicto armado,128
399,345,1033,07067,CHIQUINQUIRA,BOYACA,8110,8619,16729,303,87,17119,40893,Víctimas reconocidas Sentencia C280 y Auto 119 de 2013,12
400,346,1035,07070,CHISCAS,BOYACA,672,658,1330,40,35,1405,3519,Víctimas reconocidas Sentencia C280 y Auto 119 de 2013,1
401,340,1015,07010,ARCABUCO,BOYACA,773,882,1655,54,9,1718,4570,Víctimas de conflicto armado,127
402,332,1023,07022,BOAVITA,BOYACA,798,1002,1800,40,26,1866,5162,Víctimas de conflicto armado,28
403,341,1014,07010,ARCABUCO,BOYACA,773,882,1655,54,9,1718,4570,Víctimas reconocidas Sentencia C280 y Auto 119 de 2013,7
404,330,1025,07028,BRICEÑO,BOYACA,471,282,753,7,12,772,2098,Víctimas de conflicto armado,58
405,331,1024,07025,BOYACA,BOYACA,601,432,1033,24,16,1073,4201,Víctimas de conflicto armado,67
406,316,1072,07151,MIRAFLORES,BOYACA,2330,1233,3563,81,44,3688,7568,Víctimas reconocidas Sentencia C280 y Auto 119 de 2013,15
407,317,1073,07151,MIRAFLORES,BOYACA,2330,1233,3563,81,44,3688,7568,Víctimas de conflicto armado,937
408,318,1074,07154,MONGUA,BOYACA,397,1258,1655,25,6,1686,4003,Víctimas de conflicto armado,182
409,320,1069,07142,MACANAL,BOYACA,464,728,1192,24,19,1235,3603,Víctimas de conflicto armado,161
410,321,1057,07100,GARAGOA,BOYACA,2534,2485,5019,119,36,5174,11845,Víctimas reconocidas Sentencia C280 y Auto 119 de 2013,8
411,322,1026,07031,BUENAVISTA,BOYACA,616,790,1406,29,25,1460,4573,Víctimas reconocidas Sentencia C280 y Auto 119 de 2013,3
412,319,1075,07157,MONGUI,BOYACA,530,870,1400,29,5,1434,3643,Víctimas de conflicto armado,34
413,324,1031,07043,CERINZA,BOYACA,961,595,1556,54,18,1628,3482,Víctimas de conflicto armado,24
414,325,1030,07040,CAMPOHERMOSO,BOYACA,507,432,939,23,15,977,2508,Víctimas de conflicto armado,77
415,326,1029,07040,CAMPOHERMOSO,BOYACA,507,432,939,23,15,977,2508,Víctimas reconocidas Sentencia C280 y Auto 119 de 2013,4
416,327,1028,07037,CALDAS,BOYACA,651,453,1104,24,11,1139,3278,Víctimas de conflicto armado,48
417,328,1027,07031,BUENAVISTA,BOYACA,616,790,1406,29,25,1460,4573,Víctimas de conflicto armado,109
418,323,1055,07094,GACHANTIVA,BOYACA,621,678,1299,24,19,1342,3020,Víctimas de conflicto armado,48
419,329,1101,07215,QUIPAMA,BOYACA,637,1066,1703,32,33,1768,4928,Víctimas de conflicto armado,86
420,453,575,09078,NORCASIA,CALDAS,906,1179,2085,51,36,2172,5865,Víctimas reconocidas Sentencia C280 y Auto 119 de 2013,38
421,452,589,09115,SAMANA,CALDAS,2814,3513,6327,209,156,6692,16191,Víctimas reconocidas Sentencia C280 y Auto 119 de 2013,72
422,451,590,09115,SAMANA,CALDAS,2814,3513,6327,209,156,6692,16191,Víctimas de conflicto armado,27880
423,450,592,09124,SUPIA,CALDAS,2408,4985,7393,349,141,7883,21254,Víctimas de conflicto armado,2051
424,448,594,09130,VILLAMARIA,CALDAS,7470,9806,17276,330,130,17736,37945,Víctimas reconocidas Sentencia C280 y Auto 119 de 2013,73
425,447,595,09130,VILLAMARIA,CALDAS,7470,9806,17276,330,130,17736,37945,Víctimas de conflicto armado,2169
426,454,588,09109,SALAMINA,CALDAS,2096,3021,5117,86,173,5376,15660,Víctimas de conflicto armado,1343
427,446,596,09133,VITERBO,CALDAS,1373,3737,5110,56,38,5204,12839,Víctimas reconocidas Sentencia C280 y Auto 119 de 2013,49
428,449,593,09127,VICTORIA,CALDAS,1249,1735,2984,51,44,3079,8262,Víctimas de conflicto armado,623
429,455,585,09106,RISARALDA,CALDAS,959,2021,2980,49,35,3064,10761,Víctimas reconocidas Sentencia C280 y Auto 119 de 2013,51
430,463,577,09079,PACORA,CALDAS,1548,2727,4275,76,62,4413,12064,Víctimas reconocidas Sentencia C280 y Auto 119 de 2013,7
431,457,583,09103,RIOSUCIO,CALDAS,6070,8402,14472,399,205,15076,37633,Víctimas reconocidas Sentencia C280 y Auto 119 de 2013,143
432,458,582,09085,PENSILVANIA,CALDAS,1880,3959,5839,191,198,6228,16734,Víctimas de conflicto armado,12754
433,459,581,09085,PENSILVANIA,CALDAS,1880,3959,5839,191,198,6228,16734,Víctimas reconocidas Sentencia C280 y Auto 119 de 2013,3
434,460,580,09082,PALESTINA,CALDAS,1867,2513,4380,51,34,4465,14755,Víctimas de conflicto armado,850
435,461,579,09082,PALESTINA,CALDAS,1867,2513,4380,51,34,4465,14755,Víctimas reconocidas Sentencia C280 y Auto 119 de 2013,37
436,462,578,09079,PACORA,CALDAS,1548,2727,4275,76,62,4413,12064,Víctimas de conflicto armado,490
437,464,587,09109,SALAMINA,CALDAS,2096,3021,5117,86,173,5376,15660,Víctimas reconocidas Sentencia C280 y Auto 119 de 2013,23
438,465,551,09004,AGUADAS,CALDAS,1961,4766,6727,174,134,7035,18854,Víctimas reconocidas Sentencia C280 y Auto 119 de 2013,48
439,466,591,09124,SUPIA,CALDAS,2408,4985,7393,349,141,7883,21254,Víctimas reconocidas Sentencia C280 y Auto 119 de 2013,35
440,445,552,09004,AGUADAS,CALDAS,1961,4766,6727,174,134,7035,18854,Víctimas de conflicto armado,2197
441,456,584,09103,RIOSUCIO,CALDAS,6070,8402,14472,399,205,15076,37633,Víctimas de conflicto armado,6614
442,444,597,09133,VITERBO,CALDAS,1373,3737,5110,56,38,5204,12839,Víctimas de conflicto armado,715
443,443,576,09078,NORCASIA,CALDAS,906,1179,2085,51,36,2172,5865,Víctimas de conflicto armado,2329
444,442,586,09106,RISARALDA,CALDAS,959,2021,2980,49,35,3064,10761,Víctimas de conflicto armado,939
445,420,572,09067,MARULANDA,CALDAS,387,391,778,32,21,831,2658,Víctimas de conflicto armado,1018
446,421,564,09001,MANIZALES,CALDAS,74140,76961,151101,2505,734,154340,323102,Víctimas de conflicto armado,30560
447,422,570,09061,MARQUETALIA,CALDAS,1452,2427,3879,93,101,4073,11445,Víctimas de conflicto armado,6278
448,423,569,09061,MARQUETALIA,CALDAS,1452,2427,3879,93,101,4073,11445,Víctimas reconocidas Sentencia C280 y Auto 119 de 2013,72
449,424,568,09058,MARMATO,CALDAS,514,1133,1647,41,23,1711,6840,Víctimas de conflicto armado,154
450,425,567,09058,MARMATO,CALDAS,514,1133,1647,41,23,1711,6840,Víctimas reconocidas Sentencia C280 y Auto 119 de 2013,9
451,426,566,09055,MANZANARES,CALDAS,1773,3146,4919,91,82,5092,15465,Víctimas de conflicto armado,2490
452,428,571,09067,MARULANDA,CALDAS,387,391,778,32,21,831,2658,Víctimas reconocidas Sentencia C280 y Auto 119 de 2013,9
453,429,553,09007,ANSERMA,CALDAS,3356,7430,10786,270,153,11209,27896,Víctimas reconocidas Sentencia C280 y Auto 119 de 2013,98
454,430,562,09037,FILADELFIA,CALDAS,1365,1783,3148,62,71,3281,9343,Víctimas de conflicto armado,377
455,427,565,09055,MANZANARES,CALDAS,1773,3146,4919,91,82,5092,15465,Víctimas reconocidas Sentencia C280 y Auto 119 de 2013,33
456,432,560,09034,CHINCHINA,CALDAS,6185,10543,16728,315,162,17205,43763,Víctimas de conflicto armado,2120
457,441,574,09076,NEIRA,CALDAS,2283,4191,6474,168,101,6743,19307,Víctimas de conflicto armado,568
458,431,561,09037,FILADELFIA,CALDAS,1365,1783,3148,62,71,3281,9343,Víctimas reconocidas Sentencia C280 y Auto 119 de 2013,16
459,439,554,09007,ANSERMA,CALDAS,3356,7430,10786,270,153,11209,27896,Víctimas de conflicto armado,2778
460,438,573,09076,NEIRA,CALDAS,2283,4191,6474,168,101,6743,19307,Víctimas reconocidas Sentencia C280 y Auto 119 de 2013,19
461,437,555,09013,ARANZAZU,CALDAS,1573,2409,3982,123,86,4191,11540,Víctimas reconocidas Sentencia C280 y Auto 119 de 2013,33
462,440,563,09001,MANIZALES,CALDAS,74140,76961,151101,2505,734,154340,323102,Víctimas reconocidas Sentencia C280 y Auto 119 de 2013,479
463,435,557,09022,BELALCAZAR,CALDAS,1514,2105,3619,52,219,3890,10118,Víctimas reconocidas Sentencia C280 y Auto 119 de 2013,16
464,434,558,09022,BELALCAZAR,CALDAS,1514,2105,3619,52,219,3890,10118,Víctimas de conflicto armado,607
465,433,559,09034,CHINCHINA,CALDAS,6185,10543,16728,315,162,17205,43763,Víctimas reconocidas Sentencia C280 y Auto 119 de 2013,68
466,436,556,09013,ARANZAZU,CALDAS,1573,2409,3982,123,86,4191,11540,Víctimas de conflicto armado,689
467,476,13,44016,MILAN,CAQUETA,750,590,1340,20,9,1369,6861,Víctimas de conflicto armado,3235
468,482,19,44024,SOLITA,CAQUETA,484,804,1288,26,18,1332,5746,Víctimas de conflicto armado,4224
469,481,21,44040,VALPARAISO,CAQUETA,724,805,1529,60,22,1611,6188,Víctimas de conflicto armado,6702
470,480,20,44040,VALPARAISO,CAQUETA,724,805,1529,60,22,1611,6188,Víctimas reconocidas Sentencia C280 y Auto 119 de 2013,6
471,479,18,44024,SOLITA,CAQUETA,484,804,1288,26,18,1332,5746,Víctimas reconocidas Sentencia C280 y Auto 119 de 2013,8
472,478,15,44017,MORELIA,CAQUETA,387,731,1118,16,9,1143,3584,Víctimas de conflicto armado,2651
473,477,14,44017,MORELIA,CAQUETA,387,731,1118,16,9,1143,3584,Víctimas reconocidas Sentencia C280 y Auto 119 de 2013,27
474,475,12,44016,MILAN,CAQUETA,750,590,1340,20,9,1369,6861,Víctimas reconocidas Sentencia C280 y Auto 119 de 2013,18
475,470,7,44002,ALBANIA,CAQUETA,445,842,1287,22,121,1430,3923,Víctimas de conflicto armado,3002
476,473,10,44001,FLORENCIA,CAQUETA,14803,23593,38396,421,187,39004,115892,Víctimas reconocidas Sentencia C280 y Auto 119 de 2013,407
477,472,9,44012,CURILLO,CAQUETA,729,1052,1781,55,35,1871,7604,Víctimas de conflicto armado,4869
478,471,8,44012,CURILLO,CAQUETA,729,1052,1781,55,35,1871,7604,Víctimas reconocidas Sentencia C280 y Auto 119 de 2013,25
479,469,6,44002,ALBANIA,CAQUETA,445,842,1287,22,121,1430,3923,Víctimas reconocidas Sentencia C280 y Auto 119 de 2013,8
480,468,17,44022,SOLANO,CAQUETA,1506,460,1966,20,18,2004,7754,Víctimas de conflicto armado,2141
481,467,16,44022,SOLANO,CAQUETA,1506,460,1966,20,18,2004,7754,Víctimas reconocidas Sentencia C280 y Auto 119 de 2013,1
482,474,11,44001,FLORENCIA,CAQUETA,14803,23593,38396,421,187,39004,115892,Víctimas de conflicto armado,133037
483,499,622,46880,VILLANUEVA,CASANARE,2425,5625,8050,173,59,8282,19519,Víctimas reconocidas Sentencia C280 y Auto 119 de 2013,47
484,500,621,46865,TRINIDAD,CASANARE,735,2966,3701,87,42,3830,9211,Víctimas de conflicto armado,864
485,501,620,46865,TRINIDAD,CASANARE,735,2966,3701,87,42,3830,9211,Víctimas reconocidas Sentencia C280 y Auto 119 de 2013,8
486,502,619,46850,TAURAMENA,CASANARE,2209,6037,8246,139,60,8445,15751,Víctimas de conflicto armado,2786
487,503,611,46760,RECETOR,CASANARE,337,305,642,43,20,705,1260,Víctimas reconocidas Sentencia C280 y Auto 119 de 2013,6
488,504,617,46840,TAMARA,CASANARE,528,1350,1878,42,45,1965,4325,Víctimas de conflicto armado,596
489,507,616,46840,TAMARA,CASANARE,528,1350,1878,42,45,1965,4325,Víctimas reconocidas Sentencia C280 y Auto 119 de 2013,23
490,506,613,46800,SABANALARGA,CASANARE,680,664,1344,30,13,1387,2758,Víctimas reconocidas Sentencia C280 y Auto 119 de 2013,21
491,508,625,46001,YOPAL,CASANARE,14561,36503,51064,858,229,52151,102568,Víctimas de conflicto armado,35913
492,509,618,46850,TAURAMENA,CASANARE,2209,6037,8246,139,60,8445,15751,Víctimas reconocidas Sentencia C280 y Auto 119 de 2013,94
493,510,598,46040,AGUAZUL,CASANARE,4123,9666,13789,599,96,14484,26606,Víctimas reconocidas Sentencia C280 y Auto 119 de 2013,90
494,498,623,46880,VILLANUEVA,CASANARE,2425,5625,8050,173,59,8282,19519,Víctimas de conflicto armado,3266
495,505,612,46760,RECETOR,CASANARE,337,305,642,43,20,705,1260,Víctimas de conflicto armado,1131
496,497,624,46001,YOPAL,CASANARE,14561,36503,51064,858,229,52151,102568,Víctimas reconocidas Sentencia C280 y Auto 119 de 2013,608
497,490,606,46560,NUNCHIA,CASANARE,579,2272,2851,67,41,2959,6023,Víctimas de conflicto armado,665
498,495,614,46800,SABANALARGA,CASANARE,680,664,1344,30,13,1387,2758,Víctimas de conflicto armado,508
499,496,599,46040,AGUAZUL,CASANARE,4123,9666,13789,599,96,14484,26606,Víctimas de conflicto armado,3644
500,484,600,46120,CHAMEZA,CASANARE,663,271,934,25,9,968,1551,Víctimas de conflicto armado,1561
501,485,601,46520,MANI,CASANARE,1459,3265,4724,86,40,4850,10075,Víctimas reconocidas Sentencia C280 y Auto 119 de 2013,102
502,486,602,46520,MANI,CASANARE,1459,3265,4724,86,40,4850,10075,Víctimas de conflicto armado,3584
503,487,603,46540,MONTERREY,CASANARE,1639,3998,5637,87,38,5762,11103,Víctimas reconocidas Sentencia C280 y Auto 119 de 2013,43
504,488,604,46540,MONTERREY,CASANARE,1639,3998,5637,87,38,5762,11103,Víctimas de conflicto armado,2723
505,483,615,46815,SACAMA,CASANARE,563,97,660,77,14,751,1537,Víctimas de conflicto armado,1163
506,491,607,46640,OROCUE,CASANARE,1182,1800,2982,61,30,3073,7605,Víctimas reconocidas Sentencia C280 y Auto 119 de 2013,33
507,492,608,46640,OROCUE,CASANARE,1182,1800,2982,61,30,3073,7605,Víctimas de conflicto armado,835
508,493,609,46700,PORE,CASANARE,662,2684,3346,91,34,3471,6622,Víctimas reconocidas Sentencia C280 y Auto 119 de 2013,13
509,494,610,46700,PORE,CASANARE,662,2684,3346,91,34,3471,6622,Víctimas de conflicto armado,1558
510,489,605,46560,NUNCHIA,CASANARE,579,2272,2851,67,41,2959,6023,Víctimas reconocidas Sentencia C280 y Auto 119 de 2013,4
511,565,495,11070,ROSAS,CAUCA,1794,1211,3005,90,83,3178,8645,Víctimas reconocidas Sentencia C280 y Auto 119 de 2013,9
512,549,507,11094,TORIBIO,CAUCA,6535,1171,7706,165,349,8220,16666,Víctimas reconocidas Sentencia C280 y Auto 119 de 2013,18
513,548,508,11094,TORIBIO,CAUCA,6535,1171,7706,165,349,8220,16666,Víctimas de conflicto armado,10339
514,547,493,11001,POPAYAN,CAUCA,55296,38628,93924,1229,525,95678,225161,Víctimas reconocidas Sentencia C280 y Auto 119 de 2013,1696
515,546,491,11061,PIENDAMO,CAUCA,4840,4240,9080,149,153,9382,26554,Víctimas reconocidas Sentencia C280 y Auto 119 de 2013,66
516,544,475,11028,GUAPI,CAUCA,5596,415,6011,78,83,6172,19182,Víctimas reconocidas Sentencia C280 y Auto 119 de 2013,225
517,543,481,11046,MERCADERES,CAUCA,3135,960,4095,77,99,4271,13882,Víctimas reconocidas Sentencia C280 y Auto 119 de 2013,76
518,542,480,11034,JAMBALO,CAUCA,3270,520,3790,89,66,3945,8072,Víctimas de conflicto armado,2128
519,541,479,11034,JAMBALO,CAUCA,3270,520,3790,89,66,3945,8072,Víctimas reconocidas Sentencia C280 y Auto 119 de 2013,5
520,550,506,11091,TIMBIQUI,CAUCA,5885,370,6255,64,29,6348,14326,Víctimas de conflicto armado,13937
521,545,510,11097,TOTORO,CAUCA,2615,884,3499,57,47,3603,10804,Víctimas de conflicto armado,376
522,551,505,11091,TIMBIQUI,CAUCA,5885,370,6255,64,29,6348,14326,Víctimas reconocidas Sentencia C280 y Auto 119 de 2013,243
523,558,498,11082,SILVIA,CAUCA,5792,1804,7596,193,191,7980,21970,Víctimas de conflicto armado,872
524,553,503,11088,TIMBIO,CAUCA,5047,4057,9104,191,119,9414,24676,Víctimas reconocidas Sentencia C280 y Auto 119 de 2013,54
525,554,502,11086,SUCRE,CAUCA,1418,304,1722,31,37,1790,5460,Víctimas de conflicto armado,968
526,555,501,11086,SUCRE,CAUCA,1418,304,1722,31,37,1790,5460,Víctimas reconocidas Sentencia C280 y Auto 119 de 2013,19
527,556,500,11087,SUAREZ,CAUCA,3890,1912,5802,215,143,6160,15860,Víctimas de conflicto armado,16381
528,557,499,11087,SUAREZ,CAUCA,3890,1912,5802,215,143,6160,15860,Víctimas reconocidas Sentencia C280 y Auto 119 de 2013,53
529,559,497,11082,SILVIA,CAUCA,5792,1804,7596,193,191,7980,21970,Víctimas reconocidas Sentencia C280 y Auto 119 de 2013,5
530,560,496,11070,ROSAS,CAUCA,1794,1211,3005,90,83,3178,8645,Víctimas de conflicto armado,1959
531,561,492,11061,PIENDAMO,CAUCA,4840,4240,9080,149,153,9382,26554,Víctimas de conflicto armado,3448
532,562,466,11016,CALDONO,CAUCA,6792,1715,8507,267,169,8943,20628,Víctimas de conflicto armado,2068
533,563,467,11019,CALOTO,CAUCA,5875,2183,8058,166,70,8294,17687,Víctimas reconocidas Sentencia C280 y Auto 119 de 2013,59
534,564,494,11001,POPAYAN,CAUCA,55296,38628,93924,1229,525,95678,225161,Víctimas de conflicto armado,145218
535,539,477,11031,INZA,CAUCA,3318,1177,4495,74,80,4649,16634,Víctimas reconocidas Sentencia C280 y Auto 119 de 2013,12
536,552,504,11088,TIMBIO,CAUCA,5047,4057,9104,191,119,9414,24676,Víctimas de conflicto armado,4909
537,538,476,11028,GUAPI,CAUCA,5596,415,6011,78,83,6172,19182,Víctimas de conflicto armado,11404
538,540,478,11031,INZA,CAUCA,3318,1177,4495,74,80,4649,16634,Víctimas de conflicto armado,1129
539,536,483,11049,MIRANDA,CAUCA,5933,3379,9312,166,58,9536,18593,Víctimas reconocidas Sentencia C280 y Auto 119 de 2013,126
540,511,509,11097,TOTORO,CAUCA,2615,884,3499,57,47,3603,10804,Víctimas reconocidas Sentencia C280 y Auto 119 de 2013,12
541,512,486,11052,MORALES,CAUCA,3764,2412,6176,225,211,6612,18642,Víctimas de conflicto armado,8886
542,513,456,11004,ALMAGUER,CAUCA,2874,570,3444,169,85,3698,12511,Víctimas de conflicto armado,1122
543,514,457,11005,ARGELIA,CAUCA,5807,751,6558,175,97,6830,17783,Víctimas reconocidas Sentencia C280 y Auto 119 de 2013,225
544,515,458,11005,ARGELIA,CAUCA,5807,751,6558,175,97,6830,17783,Víctimas de conflicto armado,4745
545,516,459,11006,BALBOA,CAUCA,4425,731,5156,126,107,5389,15693,Víctimas reconocidas Sentencia C280 y Auto 119 de 2013,21
546,517,460,11006,BALBOA,CAUCA,4425,731,5156,126,107,5389,15693,Víctimas de conflicto armado,2315
547,518,485,11052,MORALES,CAUCA,3764,2412,6176,225,211,6612,18642,Víctimas reconocidas Sentencia C280 y Auto 119 de 2013,72
548,519,461,11007,BOLIVAR,CAUCA,5234,2772,8006,286,163,8455,31054,Víctimas reconocidas Sentencia C280 y Auto 119 de 2013,16
549,520,463,11013,CAJIBIO,CAUCA,4922,2002,6924,138,168,7230,23310,Víctimas reconocidas Sentencia C280 y Auto 119 de 2013,17
550,521,464,11013,CAJIBIO,CAUCA,4922,2002,6924,138,168,7230,23310,Víctimas de conflicto armado,2488
551,522,465,11016,CALDONO,CAUCA,6792,1715,8507,267,169,8943,20628,Víctimas reconocidas Sentencia C280 y Auto 119 de 2013,20
552,537,474,11029,GUACHENE,CAUCA,4160,1663,5823,202,65,6090,12259,Víctimas de conflicto armado,566
553,524,488,11053,PADILLA,CAUCA,2258,752,3010,104,35,3149,6631,Víctimas de conflicto armado,290
554,535,473,11029,GUACHENE,CAUCA,4160,1663,5823,202,65,6090,12259,Víctimas reconocidas Sentencia C280 y Auto 119 de 2013,22
555,534,472,11027,FLORENCIA,CAUCA,1530,520,2050,64,37,2151,4576,Víctimas de conflicto armado,1279
556,533,471,11027,FLORENCIA,CAUCA,1530,520,2050,64,37,2151,4576,Víctimas reconocidas Sentencia C280 y Auto 119 de 2013,39
557,532,470,11022,CORINTO,CAUCA,5669,2520,8189,187,113,8489,17445,Víctimas de conflicto armado,5206
558,531,469,11022,CORINTO,CAUCA,5669,2520,8189,187,113,8489,17445,Víctimas reconocidas Sentencia C280 y Auto 119 de 2013,91
559,523,487,11053,PADILLA,CAUCA,2258,752,3010,104,35,3149,6631,Víctimas reconocidas Sentencia C280 y Auto 119 de 2013,3
560,529,482,11046,MERCADERES,CAUCA,3135,960,4095,77,99,4271,13882,Víctimas de conflicto armado,5808
561,528,484,11049,MIRANDA,CAUCA,5933,3379,9312,166,58,9536,18593,Víctimas de conflicto armado,6014
562,527,490,11060,PIAMONTE,CAUCA,996,492,1488,31,29,1548,5010,Víctimas de conflicto armado,1854
563,526,462,11007,BOLIVAR,CAUCA,5234,2772,8006,286,163,8455,31054,Víctimas de conflicto armado,2274
564,525,489,11060,PIAMONTE,CAUCA,996,492,1488,31,29,1548,5010,Víctimas reconocidas Sentencia C280 y Auto 119 de 2013,9
565,530,468,11019,CALOTO,CAUCA,5875,2183,8058,166,70,8294,17687,Víctimas de conflicto armado,7081
566,581,935,12375,CHIRIGUANA,CESAR,3850,2666,6516,97,85,6698,20688,Víctimas de conflicto armado,11576
567,582,926,12170,ASTREA,CESAR,2004,1793,3797,40,36,3873,14110,Víctimas reconocidas Sentencia C280 y Auto 119 de 2013,38
568,583,944,12700,PELAYA,CESAR,2222,2410,4632,106,56,4794,13460,Víctimas reconocidas Sentencia C280 y Auto 119 de 2013,113
569,584,949,12001,VALLEDUPAR,CESAR,44788,41843,86631,898,379,87908,279165,Víctimas de conflicto armado,167048
570,585,948,12001,VALLEDUPAR,CESAR,44788,41843,86631,898,379,87908,279165,Víctimas reconocidas Sentencia C280 y Auto 119 de 2013,2034
571,589,943,12650,PAILITAS,CESAR,2874,1943,4817,149,57,5023,14163,Víctimas de conflicto armado,14934
572,588,945,12700,PELAYA,CESAR,2222,2410,4632,106,56,4794,13460,Víctimas de conflicto armado,8671
573,590,942,12650,PAILITAS,CESAR,2874,1943,4817,149,57,5023,14163,Víctimas reconocidas Sentencia C280 y Auto 119 de 2013,274
574,591,941,12525,GONZALEZ,CESAR,608,560,1168,44,25,1237,3867,Víctimas de conflicto armado,835
575,580,934,12375,CHIRIGUANA,CESAR,3850,2666,6516,97,85,6698,20688,Víctimas reconocidas Sentencia C280 y Auto 119 de 2013,478
576,586,947,12900,TAMALAMEQUE,CESAR,1859,892,2751,60,27,2838,10017,Víctimas de conflicto armado,1891
577,579,929,12180,BECERRIL,CESAR,2753,1787,4540,58,44,4642,14502,Víctimas de conflicto armado,10547
578,587,946,12900,TAMALAMEQUE,CESAR,1859,892,2751,60,27,2838,10017,Víctimas reconocidas Sentencia C280 y Auto 119 de 2013,156
579,577,924,12075,AGUACHICA,CESAR,8179,18389,26568,430,138,27136,65630,Víctimas reconocidas Sentencia C280 y Auto 119 de 2013,407
580,578,925,12075,AGUACHICA,CESAR,8179,18389,26568,430,138,27136,65630,Víctimas de conflicto armado,21068
581,567,939,12450,GAMARRA,CESAR,1609,1777,3386,26,26,3438,10255,Víctimas de conflicto armado,1563
582,568,938,12450,GAMARRA,CESAR,1609,1777,3386,26,26,3438,10255,Víctimas reconocidas Sentencia C280 y Auto 119 de 2013,39
583,569,937,12225,CURUMANI,CESAR,4286,2952,7238,109,64,7411,24745,Víctimas de conflicto armado,18720
584,570,936,12225,CURUMANI,CESAR,4286,2952,7238,109,64,7411,24745,Víctimas reconocidas Sentencia C280 y Auto 119 de 2013,318
585,566,940,12525,GONZALEZ,CESAR,608,560,1168,44,25,1237,3867,Víctimas reconocidas Sentencia C280 y Auto 119 de 2013,25
586,572,927,12170,ASTREA,CESAR,2004,1793,3797,40,36,3873,14110,Víctimas de conflicto armado,2801
587,573,933,12300,CHIMICHAGUA,CESAR,3327,2834,6161,95,30,6286,23597,Víctimas de conflicto armado,4469
588,574,932,12300,CHIMICHAGUA,CESAR,3327,2834,6161,95,30,6286,23597,Víctimas reconocidas Sentencia C280 y Auto 119 de 2013,119
589,575,931,12200,BOSCONIA,CESAR,4979,3593,8572,109,100,8781,26471,Víctimas de conflicto armado,16210
590,576,930,12200,BOSCONIA,CESAR,4979,3593,8572,109,100,8781,26471,Víctimas reconocidas Sentencia C280 y Auto 119 de 2013,198
591,571,928,12180,BECERRIL,CESAR,2753,1787,4540,58,44,4642,14502,Víctimas reconocidas Sentencia C280 y Auto 119 de 2013,122
592,608,532,17019,ISTMINA,CHOCO,3990,1679,5669,155,88,5912,21319,Víctimas de conflicto armado,12899
593,609,548,17043,TADO,CHOCO,2830,1238,4068,157,56,4281,12777,Víctimas de conflicto armado,7608
594,610,530,17013,CONDOTO,CHOCO,2296,863,3159,140,45,3344,10526,Víctimas de conflicto armado,3910
595,611,529,17013,CONDOTO,CHOCO,2296,863,3159,140,45,3344,10526,Víctimas reconocidas Sentencia C280 y Auto 119 de 2013,59
596,612,528,17014,CERTEGUI,CHOCO,1238,382,1620,87,2,1709,4109,Víctimas de conflicto armado,444
597,615,525,17007,BAGADO,CHOCO,2264,196,2460,46,12,2518,8376,Víctimas reconocidas Sentencia C280 y Auto 119 de 2013,18
598,614,526,17007,BAGADO,CHOCO,2264,196,2460,46,12,2518,8376,Víctimas de conflicto armado,5616
599,616,524,17004,ACANDI,CHOCO,1568,485,2053,19,33,2105,8345,Víctimas de conflicto armado,11823
600,617,523,17004,ACANDI,CHOCO,1568,485,2053,19,33,2105,8345,Víctimas reconocidas Sentencia C280 y Auto 119 de 2013,301
601,618,535,17025,LLORO,CHOCO,2128,435,2563,63,40,2666,7605,Víctimas reconocidas Sentencia C280 y Auto 119 de 2013,30
602,619,547,17043,TADO,CHOCO,2830,1238,4068,157,56,4281,12777,Víctimas reconocidas Sentencia C280 y Auto 119 de 2013,106
603,613,527,17014,CERTEGUI,CHOCO,1238,382,1620,87,2,1709,4109,Víctimas reconocidas Sentencia C280 y Auto 119 de 2013,22
604,606,534,17022,JURADO,CHOCO,580,144,724,7,13,744,3049,Víctimas de conflicto armado,1999
605,607,533,17022,JURADO,CHOCO,580,144,724,7,13,744,3049,Víctimas reconocidas Sentencia C280 y Auto 119 de 2013,10
606,604,536,17025,LLORO,CHOCO,2128,435,2563,63,40,2666,7605,Víctimas de conflicto armado,4303
607,605,531,17019,ISTMINA,CHOCO,3990,1679,5669,155,88,5912,21319,Víctimas reconocidas Sentencia C280 y Auto 119 de 2013,728
608,592,538,17028,NOVITA,CHOCO,1212,423,1635,74,30,1739,5232,Víctimas de conflicto armado,857
609,593,539,17031,NUQUI,CHOCO,1416,103,1519,12,12,1543,5413,Víctimas reconocidas Sentencia C280 y Auto 119 de 2013,100
610,595,541,17001,QUIBDO,CHOCO,20260,7159,27419,795,308,28522,80380,Víctimas reconocidas Sentencia C280 y Auto 119 de 2013,1426
611,596,542,17001,QUIBDO,CHOCO,20260,7159,27419,795,308,28522,80380,Víctimas de conflicto armado,84583
612,597,550,17048,UNGUIA,CHOCO,1426,736,2162,16,26,2204,8348,Víctimas de conflicto armado,11114
613,594,540,17031,NUQUI,CHOCO,1416,103,1519,12,12,1543,5413,Víctimas de conflicto armado,1151
614,599,545,17040,SIPI,CHOCO,618,88,706,26,17,749,2467,Víctimas reconocidas Sentencia C280 y Auto 119 de 2013,121
615,600,546,17040,SIPI,CHOCO,618,88,706,26,17,749,2467,Víctimas de conflicto armado,2124
616,601,537,17028,NOVITA,CHOCO,1212,423,1635,74,30,1739,5232,Víctimas reconocidas Sentencia C280 y Auto 119 de 2013,8
617,602,549,17048,UNGUIA,CHOCO,1426,736,2162,16,26,2204,8348,Víctimas reconocidas Sentencia C280 y Auto 119 de 2013,154
618,603,543,17034,RIOSUCIO,CHOCO,3462,345,3807,36,36,3879,13524,Víctimas reconocidas Sentencia C280 y Auto 119 de 2013,271
619,598,544,17034,RIOSUCIO,CHOCO,3462,345,3807,36,36,3879,13524,Víctimas de conflicto armado,29639
620,637,197,13027,MOÑITOS,CORDOBA,4230,1090,5320,65,51,5436,18119,Víctimas reconocidas Sentencia C280 y Auto 119 de 2013,375
621,638,189,13022,LORICA,CORDOBA,17559,8386,25945,266,167,26378,84539,Víctimas reconocidas Sentencia C280 y Auto 119 de 2013,106
622,639,177,13004,AYAPEL,CORDOBA,4178,2882,7060,81,76,7217,32199,Víctimas reconocidas Sentencia C280 y Auto 119 de 2013,561
623,640,178,13004,AYAPEL,CORDOBA,4178,2882,7060,81,76,7217,32199,Víctimas de conflicto armado,3927
624,641,179,13007,BUENAVISTA,CORDOBA,4048,1541,5589,61,46,5696,17581,Víctimas reconocidas Sentencia C280 y Auto 119 de 2013,440
625,642,180,13007,BUENAVISTA,CORDOBA,4048,1541,5589,61,46,5696,17581,Víctimas de conflicto armado,2261
626,643,181,13009,CANALETE,CORDOBA,2640,777,3417,20,31,3468,16098,Víctimas reconocidas Sentencia C280 y Auto 119 de 2013,111
627,646,184,13010,CERETE,CORDOBA,11746,11179,22925,256,104,23285,71178,Víctimas de conflicto armado,7378
628,645,190,13022,LORICA,CORDOBA,17559,8386,25945,266,167,26378,84539,Víctimas de conflicto armado,3215
629,647,183,13010,CERETE,CORDOBA,11746,11179,22925,256,104,23285,71178,Víctimas reconocidas Sentencia C280 y Auto 119 de 2013,278
630,648,186,13016,CHIMA,CORDOBA,2825,1091,3916,27,27,3970,12752,Víctimas de conflicto armado,483
631,649,188,13019,CHINU,CORDOBA,6434,6345,12779,174,273,13226,35501,Víctimas de conflicto armado,2744
632,636,191,13024,MOMIL,CORDOBA,2830,1340,4170,25,25,4220,12929,Víctimas reconocidas Sentencia C280 y Auto 119 de 2013,29
633,651,185,13016,CHIMA,CORDOBA,2825,1091,3916,27,27,3970,12752,Víctimas reconocidas Sentencia C280 y Auto 119 de 2013,11
634,644,182,13009,CANALETE,CORDOBA,2640,777,3417,20,31,3468,16098,Víctimas de conflicto armado,3145
635,650,187,13019,CHINU,CORDOBA,6434,6345,12779,174,273,13226,35501,Víctimas reconocidas Sentencia C280 y Auto 119 de 2013,172
636,635,192,13024,MOMIL,CORDOBA,2830,1340,4170,25,25,4220,12929,Víctimas de conflicto armado,716
637,633,208,13061,VALENCIA,CORDOBA,4581,2089,6670,91,90,6851,25119,Víctimas de conflicto armado,23162
638,634,193,13025,MONTELIBANO,CORDOBA,10631,7643,18274,340,155,18769,55017,Víctimas reconocidas Sentencia C280 y Auto 119 de 2013,4589
639,620,194,13025,MONTELIBANO,CORDOBA,10631,7643,18274,340,155,18769,55017,Víctimas de conflicto armado,31028
640,621,195,13001,MONTERIA,CORDOBA,44207,47850,92057,781,427,93265,302825,Víctimas reconocidas Sentencia C280 y Auto 119 de 2013,5664
641,623,198,13027,MOÑITOS,CORDOBA,4230,1090,5320,65,51,5436,18119,Víctimas de conflicto armado,2910
642,624,199,13034,PURISIMA,CORDOBA,1972,1778,3750,38,116,3904,13416,Víctimas reconocidas Sentencia C280 y Auto 119 de 2013,19
643,625,200,13034,PURISIMA,CORDOBA,1972,1778,3750,38,116,3904,13416,Víctimas de conflicto armado,847
644,622,202,13037,SAHAGUN,CORDOBA,16501,9762,26263,284,277,26824,78125,Víctimas de conflicto armado,4622
645,627,203,13058,TIERRALTA,CORDOBA,12579,5452,18031,311,323,18665,60877,Víctimas reconocidas Sentencia C280 y Auto 119 de 2013,3090
646,628,204,13058,TIERRALTA,CORDOBA,12579,5452,18031,311,323,18665,60877,Víctimas de conflicto armado,39052
647,629,205,13060,TUCHIN,CORDOBA,5273,2467,7740,197,281,8218,21288,Víctimas reconocidas Sentencia C280 y Auto 119 de 2013,105
648,630,206,13060,TUCHIN,CORDOBA,5273,2467,7740,197,281,8218,21288,Víctimas de conflicto armado,846
649,631,196,13001,MONTERIA,CORDOBA,44207,47850,92057,781,427,93265,302825,Víctimas de conflicto armado,121174
650,632,207,13061,VALENCIA,CORDOBA,4581,2089,6670,91,90,6851,25119,Víctimas reconocidas Sentencia C280 y Auto 119 de 2013,988
651,626,201,13037,SAHAGUN,CORDOBA,16501,9762,26263,284,277,26824,78125,Víctimas reconocidas Sentencia C280 y Auto 119 de 2013,420
652,761,907,15316,UTICA,CUNDINAMARCA,616,1184,1800,18,19,1837,4700,Víctimas de conflicto armado,737
653,755,923,15340,ZIPAQUIRA,CUNDINAMARCA,20348,21680,42028,807,120,42955,82209,Víctimas de conflicto armado,1507
654,756,922,15340,ZIPAQUIRA,CUNDINAMARCA,20348,21680,42028,807,120,42955,82209,Víctimas reconocidas Sentencia C280 y Auto 119 de 2013,30
655,757,921,15337,ZIPACON,CUNDINAMARCA,962,1071,2033,17,16,2066,4091,Víctimas de conflicto armado,88
656,758,920,15334,YACOPI,CUNDINAMARCA,1339,1772,3111,51,65,3227,11457,Víctimas de conflicto armado,2905
657,759,919,15334,YACOPI,CUNDINAMARCA,1339,1772,3111,51,65,3227,11457,Víctimas reconocidas Sentencia C280 y Auto 119 de 2013,24
658,760,918,15331,VIOTA,CUNDINAMARCA,1899,2006,3905,66,22,3993,10358,Víctimas de conflicto armado,7881
659,762,917,15331,VIOTA,CUNDINAMARCA,1899,2006,3905,66,22,3993,10358,Víctimas reconocidas Sentencia C280 y Auto 119 de 2013,18
660,768,910,15319,VERGARA,CUNDINAMARCA,1147,1084,2231,41,45,2317,7346,Víctimas reconocidas Sentencia C280 y Auto 119 de 2013,4
661,764,914,15325,VILLAPINZON,CUNDINAMARCA,1661,4039,5700,89,41,5830,12800,Víctimas de conflicto armado,692
662,765,913,15323,VILLAGOMEZ,CUNDINAMARCA,198,375,573,17,17,607,1915,Víctimas de conflicto armado,382
663,766,912,15322,VIANI,CUNDINAMARCA,726,673,1399,28,14,1441,3867,Víctimas de conflicto armado,196
664,767,911,15319,VERGARA,CUNDINAMARCA,1147,1084,2231,41,45,2317,7346,Víctimas de conflicto armado,668
665,754,812,15100,GACHANCIPA,CUNDINAMARCA,1718,2816,4534,113,44,4691,9080,Víctimas de conflicto armado,452
666,769,909,15318,VENECIA,CUNDINAMARCA,677,513,1190,15,8,1213,3562,Víctimas de conflicto armado,621
667,770,916,15328,VILLETA,CUNDINAMARCA,3165,5842,9007,93,49,9149,21862,Víctimas de conflicto armado,719
668,763,915,15328,VILLETA,CUNDINAMARCA,3165,5842,9007,93,49,9149,21862,Víctimas reconocidas Sentencia C280 y Auto 119 de 2013,20
669,753,908,15318,VENECIA,CUNDINAMARCA,677,513,1190,15,8,1213,3562,Víctimas reconocidas Sentencia C280 y Auto 119 de 2013,7
670,746,892,15277,TENA,CUNDINAMARCA,1238,1028,2266,23,19,2308,6197,Víctimas de conflicto armado,277
671,751,846,15178,NILO,CUNDINAMARCA,1397,1107,2504,18,9,2531,6256,Víctimas reconocidas Sentencia C280 y Auto 119 de 2013,25
672,734,904,15301,UBAQUE,CUNDINAMARCA,915,1197,2112,45,25,2182,5660,Víctimas de conflicto armado,101
673,735,903,15298,UBALA,CUNDINAMARCA,1082,1541,2623,69,35,2727,8478,Víctimas de conflicto armado,232
674,736,902,15295,TOPAIPI,CUNDINAMARCA,825,656,1481,38,27,1546,4060,Víctimas de conflicto armado,1401
675,737,901,15292,TOCANCIPA,CUNDINAMARCA,4971,6865,11836,320,43,12199,24441,Víctimas de conflicto armado,820
676,738,900,15292,TOCANCIPA,CUNDINAMARCA,4971,6865,11836,320,43,12199,24441,Víctimas reconocidas Sentencia C280 y Auto 119 de 2013,12
677,739,899,15289,TOCAIMA,CUNDINAMARCA,2351,2249,4600,60,20,4680,12896,Víctimas de conflicto armado,312
678,740,898,15289,TOCAIMA,CUNDINAMARCA,2351,2249,4600,60,20,4680,12896,Víctimas reconocidas Sentencia C280 y Auto 119 de 2013,4
679,741,905,15307,UNE,CUNDINAMARCA,1296,1606,2902,37,15,2954,6307,Víctimas de conflicto armado,379
680,742,897,15286,TIBIRITA,CUNDINAMARCA,667,357,1024,9,31,1064,3018,Víctimas de conflicto armado,73
681,743,895,15283,TIBACUY,CUNDINAMARCA,778,681,1459,20,29,1508,3706,Víctimas reconocidas Sentencia C280 y Auto 119 de 2013,19
682,744,894,15280,TENJO,CUNDINAMARCA,2903,3968,6871,93,20,6984,14029,Víctimas de conflicto armado,583
683,745,893,15280,TENJO,CUNDINAMARCA,2903,3968,6871,93,20,6984,14029,Víctimas reconocidas Sentencia C280 y Auto 119 de 2013,16
684,771,887,15271,TABIO,CUNDINAMARCA,3249,3983,7232,134,20,7386,14659,Víctimas reconocidas Sentencia C280 y Auto 119 de 2013,1
685,747,891,15277,TENA,CUNDINAMARCA,1238,1028,2266,23,19,2308,6197,Víctimas reconocidas Sentencia C280 y Auto 119 de 2013,5
686,748,890,15274,TAUSA,CUNDINAMARCA,737,1886,2623,63,19,2705,5720,Víctimas de conflicto armado,92
687,749,889,15274,TAUSA,CUNDINAMARCA,737,1886,2623,63,19,2705,5720,Víctimas reconocidas Sentencia C280 y Auto 119 de 2013,10
688,750,896,15283,TIBACUY,CUNDINAMARCA,778,681,1459,20,29,1508,3706,Víctimas de conflicto armado,1035
689,752,906,15316,UTICA,CUNDINAMARCA,616,1184,1800,18,19,1837,4700,Víctimas reconocidas Sentencia C280 y Auto 119 de 2013,2
690,772,888,15271,TABIO,CUNDINAMARCA,3249,3983,7232,134,20,7386,14659,Víctimas de conflicto armado,378
691,779,858,15199,PASCA,CUNDINAMARCA,1567,1176,2743,64,20,2827,7605,Víctimas de conflicto armado,256
692,774,863,15211,QUETAME,CUNDINAMARCA,741,1551,2292,53,7,2352,5408,Víctimas de conflicto armado,107
693,797,881,15256,SUBACHOQUE,CUNDINAMARCA,1838,4070,5908,90,21,6019,11191,Víctimas de conflicto armado,229
694,798,880,15256,SUBACHOQUE,CUNDINAMARCA,1838,4070,5908,90,21,6019,11191,Víctimas reconocidas Sentencia C280 y Auto 119 de 2013,9
695,799,878,15250,SOPO,CUNDINAMARCA,4579,4500,9079,137,27,9243,16285,Víctimas reconocidas Sentencia C280 y Auto 119 de 2013,7
696,800,866,15218,RICAURTE,CUNDINAMARCA,1688,2076,3764,17,14,3795,10455,Víctimas de conflicto armado,278
697,801,876,15247,SOACHA,CUNDINAMARCA,42449,46767,89216,1464,289,90969,201745,Víctimas reconocidas Sentencia C280 y Auto 119 de 2013,3623
698,802,877,15247,SOACHA,CUNDINAMARCA,42449,46767,89216,1464,289,90969,201745,Víctimas de conflicto armado,49612
699,803,874,15241,SILVANIA,CUNDINAMARCA,3045,3323,6368,68,44,6480,16551,Víctimas de conflicto armado,2296
700,796,882,15259,SUESCA,CUNDINAMARCA,1956,2620,4576,138,24,4738,9730,Víctimas reconocidas Sentencia C280 y Auto 119 de 2013,4
701,804,873,15241,SILVANIA,CUNDINAMARCA,3045,3323,6368,68,44,6480,16551,Víctimas reconocidas Sentencia C280 y Auto 119 de 2013,20
702,806,871,15239,SIBATE,CUNDINAMARCA,4132,6222,10354,179,45,10578,24060,Víctimas reconocidas Sentencia C280 y Auto 119 de 2013,26
703,807,870,15238,SESQUILE,CUNDINAMARCA,1488,2266,3754,109,17,3880,7764,Víctimas de conflicto armado,199
704,808,869,15238,SESQUILE,CUNDINAMARCA,1488,2266,3754,109,17,3880,7764,Víctimas reconocidas Sentencia C280 y Auto 119 de 2013,2
705,809,868,15235,SASAIMA,CUNDINAMARCA,1137,2130,3267,35,18,3320,8594,Víctimas de conflicto armado,606
706,810,875,15244,SIMIJACA,CUNDINAMARCA,1179,2097,3276,65,26,3367,8608,Víctimas de conflicto armado,96
707,811,813,15103,GACHETA,CUNDINAMARCA,1070,2036,3106,55,32,3193,9217,Víctimas reconocidas Sentencia C280 y Auto 119 de 2013,2
708,733,847,15178,NILO,CUNDINAMARCA,1397,1107,2504,18,9,2531,6256,Víctimas de conflicto armado,312
709,805,872,15239,SIBATE,CUNDINAMARCA,4132,6222,10354,179,45,10578,24060,Víctimas de conflicto armado,1172
710,795,883,15259,SUESCA,CUNDINAMARCA,1956,2620,4576,138,24,4738,9730,Víctimas de conflicto armado,271
711,794,884,15262,SUPATA,CUNDINAMARCA,574,942,1516,30,19,1565,4154,Víctimas de conflicto armado,77
712,793,867,15235,SASAIMA,CUNDINAMARCA,1137,2130,3267,35,18,3320,8594,Víctimas reconocidas Sentencia C280 y Auto 119 de 2013,1
713,775,862,15211,QUETAME,CUNDINAMARCA,741,1551,2292,53,7,2352,5408,Víctimas reconocidas Sentencia C280 y Auto 119 de 2013,3
714,776,861,15208,QUEBRADANEGRA,CUNDINAMARCA,480,1137,1617,21,13,1651,3996,Víctimas de conflicto armado,581
715,777,860,15208,QUEBRADANEGRA,CUNDINAMARCA,480,1137,1617,21,13,1651,3996,Víctimas reconocidas Sentencia C280 y Auto 119 de 2013,6
716,778,859,15205,PULI,CUNDINAMARCA,437,466,903,24,11,938,2856,Víctimas de conflicto armado,439
717,780,857,15199,PASCA,CUNDINAMARCA,1567,1176,2743,64,20,2827,7605,Víctimas reconocidas Sentencia C280 y Auto 119 de 2013,4
718,781,886,15268,SUTATAUSA,CUNDINAMARCA,563,996,1559,35,21,1615,3746,Víctimas de conflicto armado,212
719,782,856,15196,PANDI,CUNDINAMARCA,741,638,1379,23,9,1411,4122,Víctimas de conflicto armado,300
720,783,854,15193,PAIME,CUNDINAMARCA,766,692,1458,22,19,1499,4564,Víctimas de conflicto armado,309
721,784,853,15193,PAIME,CUNDINAMARCA,766,692,1458,22,19,1499,4564,Víctimas reconocidas Sentencia C280 y Auto 119 de 2013,1
722,785,852,15190,PACHO,CUNDINAMARCA,3726,3959,7685,143,76,7904,20502,Víctimas de conflicto armado,1390
723,786,851,15190,PACHO,CUNDINAMARCA,3726,3959,7685,143,76,7904,20502,Víctimas reconocidas Sentencia C280 y Auto 119 de 2013,4
724,787,850,15184,NOCAIMA,CUNDINAMARCA,1252,886,2138,40,13,2191,5169,Víctimas de conflicto armado,247
725,788,849,15184,NOCAIMA,CUNDINAMARCA,1252,886,2138,40,13,2191,5169,Víctimas reconocidas Sentencia C280 y Auto 119 de 2013,1
726,789,848,15181,NIMAIMA,CUNDINAMARCA,540,750,1290,24,12,1326,3153,Víctimas de conflicto armado,233
727,790,855,15196,PANDI,CUNDINAMARCA,741,638,1379,23,9,1411,4122,Víctimas reconocidas Sentencia C280 y Auto 119 de 2013,4
728,791,865,15218,RICAURTE,CUNDINAMARCA,1688,2076,3764,17,14,3795,10455,Víctimas reconocidas Sentencia C280 y Auto 119 de 2013,15
729,792,864,15214,QUIPILE,CUNDINAMARCA,745,1302,2047,26,22,2095,6135,Víctimas de conflicto armado,584
730,773,885,15268,SUTATAUSA,CUNDINAMARCA,563,996,1559,35,21,1615,3746,Víctimas reconocidas Sentencia C280 y Auto 119 de 2013,14
731,732,879,15250,SOPO,CUNDINAMARCA,4579,4500,9079,137,27,9243,16285,Víctimas de conflicto armado,305
732,670,826,15121,GUATAQUI,CUNDINAMARCA,402,307,709,13,10,732,2205,Víctimas de conflicto armado,47
733,730,772,15016,ARBELAEZ,CUNDINAMARCA,1496,2349,3845,45,26,3916,8852,Víctimas de conflicto armado,720
734,673,841,15169,MOSQUERA,CUNDINAMARCA,13047,16521,29568,448,86,30102,57821,Víctimas reconocidas Sentencia C280 y Auto 119 de 2013,50
735,674,840,15166,MEDINA,CUNDINAMARCA,1042,1899,2941,54,39,3034,6771,Víctimas de conflicto armado,3261
736,675,839,15166,MEDINA,CUNDINAMARCA,1042,1899,2941,54,39,3034,6771,Víctimas reconocidas Sentencia C280 y Auto 119 de 2013,41
737,676,838,15163,MANTA,CUNDINAMARCA,848,840,1688,34,17,1739,4110,Víctimas de conflicto armado,44
738,677,837,15160,MADRID,CUNDINAMARCA,10555,17404,27959,641,95,28695,54897,Víctimas de conflicto armado,2387
739,678,836,15160,MADRID,CUNDINAMARCA,10555,17404,27959,641,95,28695,54897,Víctimas reconocidas Sentencia C280 y Auto 119 de 2013,68
740,679,825,15118,GUASCA,CUNDINAMARCA,1555,2836,4391,60,21,4472,10241,Víctimas de conflicto armado,553
741,672,842,15169,MOSQUERA,CUNDINAMARCA,13047,16521,29568,448,86,30102,57821,Víctimas de conflicto armado,1687
742,680,835,15157,MACHETA,CUNDINAMARCA,762,1008,1770,35,20,1825,6109,Víctimas de conflicto armado,62
743,682,833,15136,JUNIN,CUNDINAMARCA,694,1023,1717,39,13,1769,5524,Víctimas de conflicto armado,83
744,683,832,15136,JUNIN,CUNDINAMARCA,694,1023,1717,39,13,1769,5524,Víctimas reconocidas Sentencia C280 y Auto 119 de 2013,3
745,684,831,15133,JERUSALEN,CUNDINAMARCA,474,391,865,7,16,888,2700,Víctimas de conflicto armado,29
746,685,830,15130,GUTIERREZ,CUNDINAMARCA,480,831,1311,27,5,1343,2691,Víctimas de conflicto armado,209
747,686,829,15128,GUAYABETAL,CUNDINAMARCA,513,1470,1983,36,9,2028,4467,Víctimas de conflicto armado,1128
748,687,828,15128,GUAYABETAL,CUNDINAMARCA,513,1470,1983,36,9,2028,4467,Víctimas reconocidas Sentencia C280 y Auto 119 de 2013,16
749,688,827,15124,GUATAVITA,CUNDINAMARCA,811,1279,2090,32,14,2136,4945,Víctimas de conflicto armado,15
750,681,770,15217,APULO,CUNDINAMARCA,1323,1315,2638,35,16,2689,6824,Víctimas de conflicto armado,446
751,689,834,15154,LENGUAZAQUE,CUNDINAMARCA,1011,1532,2543,77,16,2636,6966,Víctimas de conflicto armado,13
752,671,843,15172,NARIÑO,CUNDINAMARCA,353,388,741,4,3,748,2535,Víctimas de conflicto armado,13
753,669,810,15097,GACHALA,CUNDINAMARCA,736,793,1529,43,21,1593,5230,Víctimas de conflicto armado,236
754,653,822,15115,GUADUAS,CUNDINAMARCA,3388,4854,8242,181,79,8502,22188,Víctimas reconocidas Sentencia C280 y Auto 119 de 2013,22
755,654,821,15112,GUACHETA,CUNDINAMARCA,1424,2003,3427,103,36,3566,8587,Víctimas de conflicto armado,1111
756,655,820,15112,GUACHETA,CUNDINAMARCA,1424,2003,3427,103,36,3566,8587,Víctimas reconocidas Sentencia C280 y Auto 119 de 2013,65
757,656,819,15132,GRANADA,CUNDINAMARCA,1022,1171,2193,39,15,2247,5571,Víctimas de conflicto armado,454
758,657,769,15217,APULO,CUNDINAMARCA,1323,1315,2638,35,16,2689,6824,Víctimas reconocidas Sentencia C280 y Auto 119 de 2013,25
759,658,764,15007,ALBAN,CUNDINAMARCA,693,1086,1779,33,8,1820,5069,Víctimas de conflicto armado,551
760,659,817,15109,GIRARDOT,CUNDINAMARCA,12251,20971,33222,334,83,33639,81967,Víctimas de conflicto armado,3439
761,731,845,15175,NEMOCON,CUNDINAMARCA,1603,2758,4361,90,35,4486,8960,Víctimas de conflicto armado,256
762,660,768,15013,ANOLAIMA,CUNDINAMARCA,1698,2461,4159,46,36,4241,11234,Víctimas de conflicto armado,457
763,662,824,15118,GUASCA,CUNDINAMARCA,1555,2836,4391,60,21,4472,10241,Víctimas reconocidas Sentencia C280 y Auto 119 de 2013,22
764,663,765,15010,ANAPOIMA,CUNDINAMARCA,2008,2466,4474,40,17,4531,11225,Víctimas reconocidas Sentencia C280 y Auto 119 de 2013,40
765,664,816,15109,GIRARDOT,CUNDINAMARCA,12251,20971,33222,334,83,33639,81967,Víctimas reconocidas Sentencia C280 y Auto 119 de 2013,81
766,665,815,15106,GAMA,CUNDINAMARCA,540,609,1149,18,24,1191,3103,Víctimas de conflicto armado,39
767,666,814,15103,GACHETA,CUNDINAMARCA,1070,2036,3106,55,32,3193,9217,Víctimas de conflicto armado,260
768,667,818,15132,GRANADA,CUNDINAMARCA,1022,1171,2193,39,15,2247,5571,Víctimas reconocidas Sentencia C280 y Auto 119 de 2013,5
769,668,766,15010,ANAPOIMA,CUNDINAMARCA,2008,2466,4474,40,17,4531,11225,Víctimas de conflicto armado,758
770,661,767,15013,ANOLAIMA,CUNDINAMARCA,1698,2461,4159,46,36,4241,11234,Víctimas reconocidas Sentencia C280 y Auto 119 de 2013,7
771,690,771,15016,ARBELAEZ,CUNDINAMARCA,1496,2349,3845,45,26,3916,8852,Víctimas reconocidas Sentencia C280 y Auto 119 de 2013,14
772,691,786,15052,CHAGUANI,CUNDINAMARCA,740,721,1461,19,23,1503,3664,Víctimas de conflicto armado,613
773,692,773,15019,BELTRAN,CUNDINAMARCA,321,325,646,6,9,661,1987,Víctimas reconocidas Sentencia C280 y Auto 119 de 2013,1
774,714,775,15022,BITUIMA,CUNDINAMARCA,454,396,850,8,13,871,2823,Víctimas de conflicto armado,83
775,715,776,15025,BOJACA,CUNDINAMARCA,1241,1875,3116,76,16,3208,5893,Víctimas de conflicto armado,247
776,716,777,15029,CABRERA,CUNDINAMARCA,991,346,1337,79,19,1435,3457,Víctimas de conflicto armado,526
777,717,778,15030,CACHIPAY,CUNDINAMARCA,1686,1756,3442,41,22,3505,8749,Víctimas reconocidas Sentencia C280 y Auto 119 de 2013,5
778,718,779,15030,CACHIPAY,CUNDINAMARCA,1686,1756,3442,41,22,3505,8749,Víctimas de conflicto armado,425
779,719,780,15031,CAJICA,CUNDINAMARCA,9016,10722,19738,275,49,20062,38304,Víctimas reconocidas Sentencia C280 y Auto 119 de 2013,9
780,720,781,15031,CAJICA,CUNDINAMARCA,9016,10722,19738,275,49,20062,38304,Víctimas de conflicto armado,1089
781,713,774,15019,BELTRAN,CUNDINAMARCA,321,325,646,6,9,661,1987,Víctimas de conflicto armado,250
782,721,782,15034,CAPARRAPI,CUNDINAMARCA,1170,2076,3246,74,57,3377,10164,Víctimas reconocidas Sentencia C280 y Auto 119 de 2013,22
783,723,784,15037,CAQUEZA,CUNDINAMARCA,2001,3393,5394,109,22,5525,14339,Víctimas de conflicto armado,249
784,724,785,15052,CHAGUANI,CUNDINAMARCA,740,721,1461,19,23,1503,3664,Víctimas reconocidas Sentencia C280 y Auto 119 de 2013,6
785,725,809,15094,FUSAGASUGA,CUNDINAMARCA,17890,23323,41213,573,155,41941,96948,Víctimas de conflicto armado,11034
786,726,787,15055,CHIA,CUNDINAMARCA,21717,21715,43432,424,84,43940,83132,Víctimas reconocidas Sentencia C280 y Auto 119 de 2013,69
787,727,788,15055,CHIA,CUNDINAMARCA,21717,21715,43432,424,84,43940,83132,Víctimas de conflicto armado,2765
788,728,789,15058,CHIPAQUE,CUNDINAMARCA,892,1985,2877,43,8,2928,7434,Víctimas de conflicto armado,162
789,729,790,15061,CHOACHI,CUNDINAMARCA,1573,3042,4615,70,28,4713,11254,Víctimas reconocidas Sentencia C280 y Auto 119 de 2013,14
790,722,783,15034,CAPARRAPI,CUNDINAMARCA,1170,2076,3246,74,57,3377,10164,Víctimas de conflicto armado,3834
791,712,791,15061,CHOACHI,CUNDINAMARCA,1573,3042,4615,70,28,4713,11254,Víctimas de conflicto armado,191
792,711,792,15064,CHOCONTA,CUNDINAMARCA,2041,3578,5619,110,45,5774,14326,Víctimas reconocidas Sentencia C280 y Auto 119 de 2013,3
793,710,793,15064,CHOCONTA,CUNDINAMARCA,2041,3578,5619,110,45,5774,14326,Víctimas de conflicto armado,436
794,693,795,15043,COGUA,CUNDINAMARCA,2684,3935,6619,128,19,6766,12927,Víctimas de conflicto armado,277
795,694,796,15046,COTA,CUNDINAMARCA,4585,5388,9973,98,25,10096,22995,Víctimas reconocidas Sentencia C280 y Auto 119 de 2013,27
796,695,797,15046,COTA,CUNDINAMARCA,4585,5388,9973,98,25,10096,22995,Víctimas de conflicto armado,508
797,696,798,15049,CUCUNUBA,CUNDINAMARCA,728,1371,2099,49,13,2161,4708,Víctimas reconocidas Sentencia C280 y Auto 119 de 2013,10
798,697,799,15049,CUCUNUBA,CUNDINAMARCA,728,1371,2099,49,13,2161,4708,Víctimas de conflicto armado,144
799,698,844,15175,NEMOCON,CUNDINAMARCA,1603,2758,4361,90,35,4486,8960,Víctimas reconocidas Sentencia C280 y Auto 119 de 2013,2
800,699,800,15076,FACATATIVA,CUNDINAMARCA,18839,26978,45817,1056,109,46982,87088,Víctimas reconocidas Sentencia C280 y Auto 119 de 2013,195
801,700,794,15043,COGUA,CUNDINAMARCA,2684,3935,6619,128,19,6766,12927,Víctimas reconocidas Sentencia C280 y Auto 119 de 2013,4
802,701,801,15076,FACATATIVA,CUNDINAMARCA,18839,26978,45817,1056,109,46982,87088,Víctimas de conflicto armado,6361
803,702,803,15079,FOMEQUE,CUNDINAMARCA,1126,2777,3903,38,25,3966,9437,Víctimas de conflicto armado,153
804,703,804,15085,FOSCA,CUNDINAMARCA,438,1565,2003,11,8,2022,5483,Víctimas de conflicto armado,12
805,704,805,15088,FUNZA,CUNDINAMARCA,13403,17147,30550,534,56,31140,60731,Víctimas reconocidas Sentencia C280 y Auto 119 de 2013,97
806,705,806,15088,FUNZA,CUNDINAMARCA,13403,17147,30550,534,56,31140,60731,Víctimas de conflicto armado,2369
807,706,807,15091,FUQUENE,CUNDINAMARCA,773,828,1601,33,12,1646,3913,Víctimas de conflicto armado,27
808,707,808,15094,FUSAGASUGA,CUNDINAMARCA,17890,23323,41213,573,155,41941,96948,Víctimas reconocidas Sentencia C280 y Auto 119 de 2013,220
809,708,811,15100,GACHANCIPA,CUNDINAMARCA,1718,2816,4534,113,44,4691,9080,Víctimas reconocidas Sentencia C280 y Auto 119 de 2013,9
810,709,802,15079,FOMEQUE,CUNDINAMARCA,1126,2777,3903,38,25,3966,9437,Víctimas reconocidas Sentencia C280 y Auto 119 de 2013,7
811,652,823,15115,GUADUAS,CUNDINAMARCA,3388,4854,8242,181,79,8502,22188,Víctimas de conflicto armado,1705
812,813,70,50001,INIRIDA,GUAINIA,2663,2436,5099,50,45,5194,19789,Víctimas de conflicto armado,9724
813,812,69,50001,INIRIDA,GUAINIA,2663,2436,5099,50,45,5194,19789,Víctimas reconocidas Sentencia C280 y Auto 119 de 2013,65
814,814,0,54003,CALAMAR,GUAVIARE,1079,417,1496,24,17,1537,5482,Víctimas reconocidas Sentencia C280 y Auto 119 de 2013,26
815,815,1,54003,CALAMAR,GUAVIARE,1079,417,1496,24,17,1537,5482,Víctimas de conflicto armado,1797
816,816,2,54012,MIRAFLORES,GUAVIARE,848,142,990,11,12,1013,4217,Víctimas reconocidas Sentencia C280 y Auto 119 de 2013,4
817,817,3,54012,MIRAFLORES,GUAVIARE,848,142,990,11,12,1013,4217,Víctimas de conflicto armado,762
818,863,955,19010,AIPE,HUILA,2491,2917,5408,71,58,5537,14967,Víctimas de conflicto armado,1659
819,862,952,19007,AGRADO,HUILA,875,1849,2724,29,26,2779,6804,Víctimas reconocidas Sentencia C280 y Auto 119 de 2013,1
820,861,971,19037,GIGANTE,HUILA,2668,4263,6931,188,65,7184,18633,Víctimas de conflicto armado,4009
821,860,972,19040,GUADALUPE,HUILA,1331,3132,4463,83,35,4581,12391,Víctimas reconocidas Sentencia C280 y Auto 119 de 2013,3
822,859,983,19051,OPORAPA,HUILA,847,2246,3093,45,36,3174,7370,Víctimas reconocidas Sentencia C280 y Auto 119 de 2013,13
823,858,975,19043,HOBO,HUILA,1005,1250,2255,42,16,2313,5571,Víctimas de conflicto armado,974
824,856,977,19046,IQUIRA,HUILA,1110,1727,2837,40,24,2901,6862,Víctimas de conflicto armado,1471
825,864,954,19010,AIPE,HUILA,2491,2917,5408,71,58,5537,14967,Víctimas reconocidas Sentencia C280 y Auto 119 de 2013,17
826,855,978,19044,ISNOS,HUILA,2041,5426,7467,155,101,7723,18179,Víctimas reconocidas Sentencia C280 y Auto 119 de 2013,19
827,854,979,19044,ISNOS,HUILA,2041,5426,7467,155,101,7723,18179,Víctimas de conflicto armado,4211
828,853,980,19050,NATAGA,HUILA,604,1124,1728,20,22,1770,4497,Víctimas de conflicto armado,451
829,851,982,19001,NEIVA,HUILA,49083,58666,107749,1066,479,109294,255422,Víctimas de conflicto armado,83300
830,857,976,19046,IQUIRA,HUILA,1110,1727,2837,40,24,2901,6862,Víctimas reconocidas Sentencia C280 y Auto 119 de 2013,9
831,865,953,19007,AGRADO,HUILA,875,1849,2724,29,26,2779,6804,Víctimas de conflicto armado,403
832,867,950,19004,ACEVEDO,HUILA,1432,4658,6090,79,45,6214,18437,Víctimas reconocidas Sentencia C280 y Auto 119 de 2013,43
833,850,984,19051,OPORAPA,HUILA,847,2246,3093,45,36,3174,7370,Víctimas de conflicto armado,1252
834,868,958,19016,ALTAMIRA,HUILA,439,561,1000,11,5,1016,2991,Víctimas reconocidas Sentencia C280 y Auto 119 de 2013,9
835,869,960,19019,BARAYA,HUILA,1206,1057,2263,17,27,2307,5983,Víctimas reconocidas Sentencia C280 y Auto 119 de 2013,10
836,870,961,19019,BARAYA,HUILA,1206,1057,2263,17,27,2307,5983,Víctimas de conflicto armado,2470
837,871,959,19016,ALTAMIRA,HUILA,439,561,1000,11,5,1016,2991,Víctimas de conflicto armado,527
838,872,963,19022,CAMPOALEGRE,HUILA,3811,6134,9945,173,63,10181,24718,Víctimas de conflicto armado,4672
839,873,964,19028,COLOMBIA,HUILA,952,1431,2383,26,33,2442,6752,Víctimas reconocidas Sentencia C280 y Auto 119 de 2013,2
840,874,965,19028,COLOMBIA,HUILA,952,1431,2383,26,33,2442,6752,Víctimas de conflicto armado,2991
841,875,966,19031,ELIAS,HUILA,645,682,1327,14,14,1355,3169,Víctimas reconocidas Sentencia C280 y Auto 119 de 2013,5
842,876,967,19031,ELIAS,HUILA,645,682,1327,14,14,1355,3169,Víctimas de conflicto armado,240
843,877,968,19034,GARZON,HUILA,6356,12101,18457,287,158,18902,51641,Víctimas reconocidas Sentencia C280 y Auto 119 de 2013,94
844,878,969,19034,GARZON,HUILA,6356,12101,18457,287,158,18902,51641,Víctimas de conflicto armado,13581
845,879,962,19022,CAMPOALEGRE,HUILA,3811,6134,9945,173,63,10181,24718,Víctimas reconocidas Sentencia C280 y Auto 119 de 2013,62
846,880,970,19037,GIGANTE,HUILA,2668,4263,6931,188,65,7184,18633,Víctimas reconocidas Sentencia C280 y Auto 119 de 2013,47
847,866,951,19004,ACEVEDO,HUILA,1432,4658,6090,79,45,6214,18437,Víctimas de conflicto armado,4143
848,849,993,19061,PITALITO,HUILA,10660,19996,30656,405,179,31240,89760,Víctimas reconocidas Sentencia C280 y Auto 119 de 2013,311
849,852,981,19001,NEIVA,HUILA,49083,58666,107749,1066,479,109294,255422,Víctimas reconocidas Sentencia C280 y Auto 119 de 2013,541
850,847,986,19052,PAICOL,HUILA,604,1522,2126,27,22,2175,4738,Víctimas de conflicto armado,405
851,818,957,19013,ALGECIRAS,HUILA,2761,2306,5067,92,75,5234,14338,Víctimas de conflicto armado,2099
852,819,996,19064,RIVERA,HUILA,2919,3446,6365,90,40,6495,16199,Víctimas de conflicto armado,2072
853,820,997,19067,SALADOBLANCO,HUILA,1420,1936,3356,53,38,3447,8635,Víctimas reconocidas Sentencia C280 y Auto 119 de 2013,16
854,821,998,19067,SALADOBLANCO,HUILA,1420,1936,3356,53,38,3447,8635,Víctimas de conflicto armado,1939
855,822,999,19076,SUAZA,HUILA,1027,2183,3210,56,41,3307,11911,Víctimas reconocidas Sentencia C280 y Auto 119 de 2013,57
856,823,1000,19076,SUAZA,HUILA,1027,2183,3210,56,41,3307,11911,Víctimas de conflicto armado,4200
857,824,1001,19079,TARQUI,HUILA,1427,3015,4442,59,31,4532,11492,Víctimas reconocidas Sentencia C280 y Auto 119 de 2013,25
858,825,1002,19079,TARQUI,HUILA,1427,3015,4442,59,31,4532,11492,Víctimas de conflicto armado,3594
859,826,1003,19082,TELLO,HUILA,1899,2120,4019,83,37,4139,10814,Víctimas reconocidas Sentencia C280 y Auto 119 de 2013,2
860,827,1004,19082,TELLO,HUILA,1899,2120,4019,83,37,4139,10814,Víctimas de conflicto armado,784
861,848,985,19052,PAICOL,HUILA,604,1522,2126,27,22,2175,4738,Víctimas reconocidas Sentencia C280 y Auto 119 de 2013,9
862,829,995,19064,RIVERA,HUILA,2919,3446,6365,90,40,6495,16199,Víctimas reconocidas Sentencia C280 y Auto 119 de 2013,37
863,830,1007,19088,TIMANA,HUILA,1441,4471,5912,65,64,6041,15078,Víctimas reconocidas Sentencia C280 y Auto 119 de 2013,51
864,831,1008,19088,TIMANA,HUILA,1441,4471,5912,65,64,6041,15078,Víctimas de conflicto armado,2027
865,832,1009,19091,VILLAVIEJA,HUILA,1480,1086,2566,44,22,2632,6524,Víctimas reconocidas Sentencia C280 y Auto 119 de 2013,3
866,828,1006,19085,TERUEL,HUILA,738,1799,2537,36,11,2584,6481,Víctimas de conflicto armado,955
867,834,1011,19094,YAGUARA,HUILA,1137,1802,2939,39,5,2983,6750,Víctimas reconocidas Sentencia C280 y Auto 119 de 2013,10
868,846,987,19055,PALERMO,HUILA,2901,4814,7715,79,37,7831,20533,Víctimas reconocidas Sentencia C280 y Auto 119 de 2013,51
869,833,1010,19091,VILLAVIEJA,HUILA,1480,1086,2566,44,22,2632,6524,Víctimas de conflicto armado,528
870,845,988,19055,PALERMO,HUILA,2901,4814,7715,79,37,7831,20533,Víctimas de conflicto armado,2682
871,844,989,19056,PALESTINA,HUILA,1146,1876,3022,64,34,3120,8509,Víctimas reconocidas Sentencia C280 y Auto 119 de 2013,11
872,843,990,19056,PALESTINA,HUILA,1146,1876,3022,64,34,3120,8509,Víctimas de conflicto armado,1634
873,841,992,19058,PITAL,HUILA,1016,2565,3581,55,22,3658,9123,Víctimas de conflicto armado,1241
874,842,991,19058,PITAL,HUILA,1016,2565,3581,55,22,3658,9123,Víctimas reconocidas Sentencia C280 y Auto 119 de 2013,1
875,839,956,19013,ALGECIRAS,HUILA,2761,2306,5067,92,75,5234,14338,Víctimas reconocidas Sentencia C280 y Auto 119 de 2013,9
876,838,994,19061,PITALITO,HUILA,10660,19996,30656,405,179,31240,89760,Víctimas de conflicto armado,31923
877,837,1005,19085,TERUEL,HUILA,738,1799,2537,36,11,2584,6481,Víctimas reconocidas Sentencia C280 y Auto 119 de 2013,4
878,836,974,19043,HOBO,HUILA,1005,1250,2255,42,16,2313,5571,Víctimas reconocidas Sentencia C280 y Auto 119 de 2013,15
879,835,1012,19094,YAGUARA,HUILA,1137,1802,2939,39,5,2983,6750,Víctimas de conflicto armado,629
880,840,973,19040,GUADALUPE,HUILA,1331,3132,4463,83,35,4581,12391,Víctimas de conflicto armado,2649
881,898,231,48001,RIOHACHA,LA GUAJIRA,17613,10092,27705,298,287,28290,111639,Víctimas de conflicto armado,73260
882,896,229,48011,MANAURE,LA GUAJIRA,1768,1418,3186,44,30,3260,52567,Víctimas de conflicto armado,954
883,897,230,48001,RIOHACHA,LA GUAJIRA,17613,10092,27705,298,287,28290,111639,Víctimas reconocidas Sentencia C280 y Auto 119 de 2013,2131
884,899,232,48016,URIBIA,LA GUAJIRA,1713,1658,3371,44,19,3434,101417,Víctimas reconocidas Sentencia C280 y Auto 119 de 2013,25
885,895,228,48011,MANAURE,LA GUAJIRA,1768,1418,3186,44,30,3260,52567,Víctimas reconocidas Sentencia C280 y Auto 119 de 2013,24
886,901,214,48002,ALBANIA,LA GUAJIRA,2333,1655,3988,64,87,4139,16633,Víctimas reconocidas Sentencia C280 y Auto 119 de 2013,127
887,902,236,48020,VILLANUEVA,LA GUAJIRA,3490,2425,5915,79,50,6044,18149,Víctimas reconocidas Sentencia C280 y Auto 119 de 2013,59
888,903,237,48020,VILLANUEVA,LA GUAJIRA,3490,2425,5915,79,50,6044,18149,Víctimas de conflicto armado,8377
889,904,226,48010,MAICAO,LA GUAJIRA,10766,9563,20329,187,257,20773,120312,Víctimas reconocidas Sentencia C280 y Auto 119 de 2013,307
890,900,234,48018,URUMITA,LA GUAJIRA,2042,1141,3183,32,10,3225,7997,Víctimas reconocidas Sentencia C280 y Auto 119 de 2013,61
891,894,227,48010,MAICAO,LA GUAJIRA,10766,9563,20329,187,257,20773,120312,Víctimas de conflicto armado,12429
892,893,235,48018,URUMITA,LA GUAJIRA,2042,1141,3183,32,10,3225,7997,Víctimas de conflicto armado,3466
893,892,225,48009,HATONUEVO,LA GUAJIRA,2846,1304,4150,59,31,4240,14034,Víctimas de conflicto armado,2126
894,881,219,48005,DIBULLA,LA GUAJIRA,3306,1309,4615,68,49,4732,20549,Víctimas de conflicto armado,12782
895,882,223,48007,FONSECA,LA GUAJIRA,6402,2463,8865,101,40,9006,25836,Víctimas de conflicto armado,10126
896,883,222,48007,FONSECA,LA GUAJIRA,6402,2463,8865,101,40,9006,25836,Víctimas reconocidas Sentencia C280 y Auto 119 de 2013,185
897,885,220,48008,DISTRACCION,LA GUAJIRA,1587,892,2479,31,12,2522,8243,Víctimas reconocidas Sentencia C280 y Auto 119 de 2013,40
898,886,233,48016,URIBIA,LA GUAJIRA,1713,1658,3371,44,19,3434,101417,Víctimas de conflicto armado,1665
899,884,221,48008,DISTRACCION,LA GUAJIRA,1587,892,2479,31,12,2522,8243,Víctimas de conflicto armado,1428
900,888,216,48004,BARRANCAS,LA GUAJIRA,4562,1806,6368,73,13,6454,23913,Víctimas reconocidas Sentencia C280 y Auto 119 de 2013,115
901,889,215,48002,ALBANIA,LA GUAJIRA,2333,1655,3988,64,87,4139,16633,Víctimas de conflicto armado,4125
902,890,224,48009,HATONUEVO,LA GUAJIRA,2846,1304,4150,59,31,4240,14034,Víctimas reconocidas Sentencia C280 y Auto 119 de 2013,41
903,891,218,48005,DIBULLA,LA GUAJIRA,3306,1309,4615,68,49,4732,20549,Víctimas reconocidas Sentencia C280 y Auto 119 de 2013,827
904,887,217,48004,BARRANCAS,LA GUAJIRA,4562,1806,6368,73,13,6454,23913,Víctimas de conflicto armado,5944
905,926,671,21031,FUNDACION,MAGDALENA,4609,4308,8917,97,35,9049,51126,Víctimas de conflicto armado,35135
906,922,681,21055,PUEBLOVIEJO,MAGDALENA,1957,1920,3877,37,108,4022,20274,Víctimas de conflicto armado,5131
907,923,691,21090,ZAPAYAN,MAGDALENA,2119,489,2608,21,19,2648,7739,Víctimas de conflicto armado,2651
908,924,679,21052,PLATO,MAGDALENA,6312,3303,9615,98,92,9805,39220,Víctimas de conflicto armado,20467
909,925,680,21055,PUEBLOVIEJO,MAGDALENA,1957,1920,3877,37,108,4022,20274,Víctimas reconocidas Sentencia C280 y Auto 119 de 2013,94
910,927,672,21040,GUAMAL,MAGDALENA,2989,1643,4632,36,47,4715,22148,Víctimas reconocidas Sentencia C280 y Auto 119 de 2013,29
911,934,674,21046,PEDRAZA,MAGDALENA,1340,552,1892,14,20,1926,8926,Víctimas reconocidas Sentencia C280 y Auto 119 de 2013,19
912,929,669,21020,CONCORDIA,MAGDALENA,2251,341,2592,16,15,2623,10564,Víctimas de conflicto armado,1294
913,930,675,21046,PEDRAZA,MAGDALENA,1340,552,1892,14,20,1926,8926,Víctimas de conflicto armado,1736
914,931,676,21049,PIVIJAY,MAGDALENA,6313,933,7246,84,48,7378,28335,Víctimas reconocidas Sentencia C280 y Auto 119 de 2013,49
915,932,677,21049,PIVIJAY,MAGDALENA,6313,933,7246,84,48,7378,28335,Víctimas de conflicto armado,19393
916,921,682,21058,REMOLINO,MAGDALENA,1716,200,1916,15,12,1943,7037,Víctimas reconocidas Sentencia C280 y Auto 119 de 2013,57
917,928,673,21040,GUAMAL,MAGDALENA,2989,1643,4632,36,47,4715,22148,Víctimas de conflicto armado,905
918,920,683,21058,REMOLINO,MAGDALENA,1716,200,1916,15,12,1943,7037,Víctimas de conflicto armado,11047
919,933,678,21052,PLATO,MAGDALENA,6312,3303,9615,98,92,9805,39220,Víctimas reconocidas Sentencia C280 y Auto 119 de 2013,396
920,918,685,21067,SALAMINA,MAGDALENA,738,557,1295,10,8,1313,7454,Víctimas de conflicto armado,3159
921,905,664,21010,ARACATACA,MAGDALENA,962,555,1517,25,8,1550,26547,Víctimas reconocidas Sentencia C280 y Auto 119 de 2013,296
922,907,662,21008,ALGARROBO,MAGDALENA,1525,467,1992,28,21,2041,9422,Víctimas reconocidas Sentencia C280 y Auto 119 de 2013,70
923,908,663,21008,ALGARROBO,MAGDALENA,1525,467,1992,28,21,2041,9422,Víctimas de conflicto armado,4993
924,909,666,21016,CIENAGA,MAGDALENA,8629,8670,17299,117,388,17804,81617,Víctimas reconocidas Sentencia C280 y Auto 119 de 2013,490
925,910,670,21031,FUNDACION,MAGDALENA,4609,4308,8917,97,35,9049,51126,Víctimas reconocidas Sentencia C280 y Auto 119 de 2013,279
926,911,668,21020,CONCORDIA,MAGDALENA,2251,341,2592,16,15,2623,10564,Víctimas reconocidas Sentencia C280 y Auto 119 de 2013,3
927,906,665,21010,ARACATACA,MAGDALENA,962,555,1517,25,8,1550,26547,Víctimas de conflicto armado,12137
928,913,690,21090,ZAPAYAN,MAGDALENA,2119,489,2608,21,19,2648,7739,Víctimas reconocidas Sentencia C280 y Auto 119 de 2013,20
929,912,667,21016,CIENAGA,MAGDALENA,8629,8670,17299,117,388,17804,81617,Víctimas de conflicto armado,17595
930,917,686,21079,SITIONUEVO,MAGDALENA,1649,764,2413,19,88,2520,17808,Víctimas reconocidas Sentencia C280 y Auto 119 de 2013,38
931,919,684,21067,SALAMINA,MAGDALENA,738,557,1295,10,8,1313,7454,Víctimas reconocidas Sentencia C280 y Auto 119 de 2013,9
932,915,688,21085,TENERIFE,MAGDALENA,2469,438,2907,39,28,2974,9842,Víctimas reconocidas Sentencia C280 y Auto 119 de 2013,53
933,914,689,21085,TENERIFE,MAGDALENA,2469,438,2907,39,28,2974,9842,Víctimas de conflicto armado,3684
934,916,687,21079,SITIONUEVO,MAGDALENA,1649,764,2413,19,88,2520,17808,Víctimas de conflicto armado,6694
935,947,325,52046,MAPIRIPAN,META,697,505,1202,33,12,1247,5394,Víctimas reconocidas Sentencia C280 y Auto 119 de 2013,26
936,956,334,52001,VILLAVICENCIO,META,56633,100830,157463,1757,400,159620,343296,Víctimas de conflicto armado,142568
937,955,323,52042,LEJANIAS,META,1287,1636,2923,92,39,3054,7903,Víctimas reconocidas Sentencia C280 y Auto 119 de 2013,46
938,953,332,52074,URIBE,META,2036,140,2176,14,24,2214,4724,Víctimas de conflicto armado,1291
939,952,331,52074,URIBE,META,2036,140,2176,14,24,2214,4724,Víctimas reconocidas Sentencia C280 y Auto 119 de 2013,15
940,951,330,52050,RESTREPO,META,2464,3557,6021,60,23,6104,14935,Víctimas de conflicto armado,2518
941,950,329,52050,RESTREPO,META,2464,3557,6021,60,23,6104,14935,Víctimas reconocidas Sentencia C280 y Auto 119 de 2013,89
942,949,327,52044,MESETAS,META,1843,1126,2969,46,30,3045,7585,Víctimas reconocidas Sentencia C280 y Auto 119 de 2013,33
943,948,326,52046,MAPIRIPAN,META,697,505,1202,33,12,1247,5394,Víctimas de conflicto armado,5080
944,954,333,52001,VILLAVICENCIO,META,56633,100830,157463,1757,400,159620,343296,Víctimas reconocidas Sentencia C280 y Auto 119 de 2013,1878
945,946,324,52042,LEJANIAS,META,1287,1636,2923,92,39,3054,7903,Víctimas de conflicto armado,3275
946,944,322,52040,GUAMAL,META,1316,4078,5394,62,15,5471,10375,Víctimas de conflicto armado,1147
947,945,328,52044,MESETAS,META,1843,1126,2969,46,30,3045,7585,Víctimas de conflicto armado,2254
948,935,313,52005,ACACIAS,META,7978,21513,29491,663,130,30284,56070,Víctimas reconocidas Sentencia C280 y Auto 119 de 2013,365
949,936,321,52040,GUAMAL,META,1316,4078,5394,62,15,5471,10375,Víctimas reconocidas Sentencia C280 y Auto 119 de 2013,35
950,937,314,52005,ACACIAS,META,7978,21513,29491,663,130,30284,56070,Víctimas de conflicto armado,13882
951,938,315,52008,CABUYARO,META,718,1182,1900,30,13,1943,4569,Víctimas reconocidas Sentencia C280 y Auto 119 de 2013,34
952,942,319,52035,GRANADA,META,7007,12415,19422,421,125,19968,48638,Víctimas reconocidas Sentencia C280 y Auto 119 de 2013,260
953,940,317,52020,CUMARAL,META,2456,5099,7555,115,31,7701,15494,Víctimas reconocidas Sentencia C280 y Auto 119 de 2013,144
954,941,318,52020,CUMARAL,META,2456,5099,7555,115,31,7701,15494,Víctimas de conflicto armado,4696
955,943,320,52035,GRANADA,META,7007,12415,19422,421,125,19968,48638,Víctimas de conflicto armado,18658
956,939,316,52008,CABUYARO,META,718,1182,1900,30,13,1943,4569,Víctimas de conflicto armado,562
957,1011,700,23019,BUESACO,NARIÑO,2921,2914,5835,109,85,6029,16930,Víctimas de conflicto armado,2020
958,1010,706,23028,CONTADERO,NARIÑO,1036,903,1939,25,23,1987,5544,Víctimas de conflicto armado,122
959,1009,713,23049,FUNES,NARIÑO,1575,737,2312,31,38,2381,5549,Víctimas reconocidas Sentencia C280 y Auto 119 de 2013,15
960,1008,708,23031,CORDOBA,NARIÑO,2138,1301,3439,53,72,3564,10104,Víctimas de conflicto armado,3765
961,1007,725,23067,IPIALES,NARIÑO,15864,15842,31706,503,617,32826,92217,Víctimas reconocidas Sentencia C280 y Auto 119 de 2013,185
962,1006,736,23097,OSPINA,NARIÑO,1102,637,1739,26,38,1803,5668,Víctimas de conflicto armado,64
963,1005,735,23097,OSPINA,NARIÑO,1102,637,1739,26,38,1803,5668,Víctimas reconocidas Sentencia C280 y Auto 119 de 2013,6
964,1003,733,23096,NARIÑO,NARIÑO,988,649,1637,21,15,1673,4120,Víctimas reconocidas Sentencia C280 y Auto 119 de 2013,25
965,1002,732,23094,MOSQUERA,NARIÑO,1975,224,2199,22,13,2234,5897,Víctimas de conflicto armado,1238
966,1001,731,23094,MOSQUERA,NARIÑO,1975,224,2199,22,13,2234,5897,Víctimas reconocidas Sentencia C280 y Auto 119 de 2013,51
967,1000,730,23082,LINARES,NARIÑO,3047,452,3499,64,69,3632,8485,Víctimas de conflicto armado,2539
968,998,728,23080,LEIVA,NARIÑO,2605,277,2882,44,47,2973,7254,Víctimas de conflicto armado,3008
969,997,727,23080,LEIVA,NARIÑO,2605,277,2882,44,47,2973,7254,Víctimas reconocidas Sentencia C280 y Auto 119 de 2013,85
970,1012,699,23019,BUESACO,NARIÑO,2921,2914,5835,109,85,6029,16930,Víctimas reconocidas Sentencia C280 y Auto 119 de 2013,48
971,996,724,23064,IMUES,NARIÑO,1156,912,2068,28,33,2129,6314,Víctimas de conflicto armado,403
972,1004,734,23096,NARIÑO,NARIÑO,988,649,1637,21,15,1673,4120,Víctimas de conflicto armado,672
973,999,729,23082,LINARES,NARIÑO,3047,452,3499,64,69,3632,8485,Víctimas reconocidas Sentencia C280 y Auto 119 de 2013,53
974,973,754,23118,SANDONA,NARIÑO,4208,2346,6554,112,107,6773,15906,Víctimas de conflicto armado,3064
975,1014,697,23017,BELEN,NARIÑO,1418,934,2352,32,35,2419,5328,Víctimas reconocidas Sentencia C280 y Auto 119 de 2013,3
976,995,709,23037,CUMBAL,NARIÑO,5421,3085,8506,216,131,8853,23407,Víctimas reconocidas Sentencia C280 y Auto 119 de 2013,20
977,1028,702,23038,CHACHAGUI,NARIÑO,2377,1427,3804,50,43,3897,9510,Víctimas de conflicto armado,1338
978,1027,705,23028,CONTADERO,NARIÑO,1036,903,1939,25,23,1987,5544,Víctimas reconocidas Sentencia C280 y Auto 119 de 2013,7
979,1026,704,23025,CONSACA,NARIÑO,1969,1434,3403,83,55,3541,8497,Víctimas de conflicto armado,1741
980,1025,761,23142,TUQUERRES,NARIÑO,6384,3521,9905,268,147,10320,34090,Víctimas de conflicto armado,2160
981,1024,760,23142,TUQUERRES,NARIÑO,6384,3521,9905,268,147,10320,34090,Víctimas reconocidas Sentencia C280 y Auto 119 de 2013,38
982,1023,759,23136,TANGUA,NARIÑO,1659,1467,3126,46,26,3198,9879,Víctimas de conflicto armado,1652
983,1022,703,23025,CONSACA,NARIÑO,1969,1434,3403,83,55,3541,8497,Víctimas reconocidas Sentencia C280 y Auto 119 de 2013,36
984,1021,707,23031,CORDOBA,NARIÑO,2138,1301,3439,53,72,3564,10104,Víctimas reconocidas Sentencia C280 y Auto 119 de 2013,32
985,1020,701,23038,CHACHAGUI,NARIÑO,2377,1427,3804,50,43,3897,9510,Víctimas reconocidas Sentencia C280 y Auto 119 de 2013,101
986,1019,692,23007,ALDANA,NARIÑO,1298,1268,2566,52,38,2656,5756,Víctimas de conflicto armado,154
987,1018,693,23010,ANCUYA,NARIÑO,1683,631,2314,35,32,2381,7235,Víctimas reconocidas Sentencia C280 y Auto 119 de 2013,31
988,1017,694,23010,ANCUYA,NARIÑO,1683,631,2314,35,32,2381,7235,Víctimas de conflicto armado,1004
989,1016,695,23016,BARBACOAS,NARIÑO,3159,1063,4222,63,76,4361,20859,Víctimas reconocidas Sentencia C280 y Auto 119 de 2013,113
990,1015,696,23016,BARBACOAS,NARIÑO,3159,1063,4222,63,76,4361,20859,Víctimas de conflicto armado,12094
991,1013,698,23017,BELEN,NARIÑO,1418,934,2352,32,35,2419,5328,Víctimas de conflicto armado,186
992,994,723,23064,IMUES,NARIÑO,1156,912,2068,28,33,2129,6314,Víctimas reconocidas Sentencia C280 y Auto 119 de 2013,28
993,966,747,23106,PUPIALES,NARIÑO,2820,3010,5830,140,63,6033,14600,Víctimas reconocidas Sentencia C280 y Auto 119 de 2013,5
994,992,721,23061,ILES,NARIÑO,1430,857,2287,45,37,2369,6900,Víctimas reconocidas Sentencia C280 y Auto 119 de 2013,8
995,971,752,23115,SAMANIEGO,NARIÑO,7072,1359,8431,166,69,8666,22140,Víctimas de conflicto armado,19600
996,970,751,23115,SAMANIEGO,NARIÑO,7072,1359,8431,166,69,8666,22140,Víctimas reconocidas Sentencia C280 y Auto 119 de 2013,188
997,993,722,23061,ILES,NARIÑO,1430,857,2287,45,37,2369,6900,Víctimas de conflicto armado,492
998,968,749,23109,RICAURTE,NARIÑO,1947,974,2921,48,79,3048,13557,Víctimas reconocidas Sentencia C280 y Auto 119 de 2013,285
999,967,748,23106,PUPIALES,NARIÑO,2820,3010,5830,140,63,6033,14600,Víctimas de conflicto armado,642
1000,965,746,23103,PUERRES,NARIÑO,2191,997,3188,70,34,3292,7410,Víctimas de conflicto armado,756
1001,972,753,23118,SANDONA,NARIÑO,4208,2346,6554,112,107,6773,15906,Víctimas reconocidas Sentencia C280 y Auto 119 de 2013,141
1002,964,745,23103,PUERRES,NARIÑO,2191,997,3188,70,34,3292,7410,Víctimas reconocidas Sentencia C280 y Auto 119 de 2013,13
1003,962,743,23101,PROVIDENCIA,NARIÑO,1586,228,1814,26,50,1890,4259,Víctimas reconocidas Sentencia C280 y Auto 119 de 2013,28
1004,961,742,23100,POTOSI,NARIÑO,1590,1809,3399,63,48,3510,9425,Víctimas de conflicto armado,847
1005,960,741,23100,POTOSI,NARIÑO,1590,1809,3399,63,48,3510,9425,Víctimas reconocidas Sentencia C280 y Auto 119 de 2013,12
1006,959,726,23067,IPIALES,NARIÑO,15864,15842,31706,503,617,32826,92217,Víctimas de conflicto armado,10764
1007,958,762,23145,YACUANQUER,NARIÑO,2169,1034,3203,88,61,3352,8133,Víctimas reconocidas Sentencia C280 y Auto 119 de 2013,7
1008,957,763,23145,YACUANQUER,NARIÑO,2169,1034,3203,88,61,3352,8133,Víctimas de conflicto armado,463
1009,963,744,23101,PROVIDENCIA,NARIÑO,1586,228,1814,26,50,1890,4259,Víctimas de conflicto armado,1273
1010,974,755,23130,SAPUYES,NARIÑO,1089,715,1804,32,21,1857,5628,Víctimas de conflicto armado,185
1011,969,750,23109,RICAURTE,NARIÑO,1947,974,2921,48,79,3048,13557,Víctimas de conflicto armado,9695
1012,976,757,23133,TAMINANGO,NARIÑO,3792,1028,4820,94,100,5014,13578,Víctimas de conflicto armado,12545
1013,991,720,23058,GUALMATAN,NARIÑO,1404,932,2336,32,15,2383,5077,Víctimas de conflicto armado,103
1014,990,719,23058,GUALMATAN,NARIÑO,1404,932,2336,32,15,2383,5077,Víctimas reconocidas Sentencia C280 y Auto 119 de 2013,4
1015,989,718,23055,GUAITARILLA,NARIÑO,2255,800,3055,47,51,3153,10811,Víctimas de conflicto armado,295
1016,975,756,23133,TAMINANGO,NARIÑO,3792,1028,4820,94,100,5014,13578,Víctimas reconocidas Sentencia C280 y Auto 119 de 2013,387
1017,987,716,23052,GUACHUCAL,NARIÑO,2511,1938,4449,78,54,4581,14068,Víctimas de conflicto armado,197
1018,986,715,23052,GUACHUCAL,NARIÑO,2511,1938,4449,78,54,4581,14068,Víctimas reconocidas Sentencia C280 y Auto 119 de 2013,5
1019,985,714,23049,FUNES,NARIÑO,1575,737,2312,31,38,2381,5549,Víctimas de conflicto armado,523
1020,984,737,23001,PASTO,NARIÑO,70354,41981,112335,1505,501,114341,279784,Víctimas reconocidas Sentencia C280 y Auto 119 de 2013,2468
1021,988,717,23055,GUAITARILLA,NARIÑO,2255,800,3055,47,51,3153,10811,Víctimas reconocidas Sentencia C280 y Auto 119 de 2013,3
1022,982,739,23098,POLICARPA,NARIÑO,3690,461,4151,51,55,4257,9537,Víctimas reconocidas Sentencia C280 y Auto 119 de 2013,538
1023,981,740,23098,POLICARPA,NARIÑO,3690,461,4151,51,55,4257,9537,Víctimas de conflicto armado,9642
1024,980,710,23037,CUMBAL,NARIÑO,5421,3085,8506,216,131,8853,23407,Víctimas de conflicto armado,1355
1025,979,711,23039,CUMBITARA,NARIÑO,2119,299,2418,25,19,2462,6203,Víctimas reconocidas Sentencia C280 y Auto 119 de 2013,300
1026,978,712,23039,CUMBITARA,NARIÑO,2119,299,2418,25,19,2462,6203,Víctimas de conflicto armado,4114
1027,977,758,23136,TANGUA,NARIÑO,1659,1467,3126,46,26,3198,9879,Víctimas reconocidas Sentencia C280 y Auto 119 de 2013,24
1028,983,738,23001,PASTO,NARIÑO,70354,41981,112335,1505,501,114341,279784,Víctimas de conflicto armado,96238
1029,1065,163,25070,RAGONVALIA,NORTE DE SANTANDER,422,1266,1688,23,17,1728,6440,Víctimas de conflicto armado,270
1030,1064,169,25085,SARDINATA,NORTE DE SANTANDER,1991,3725,5716,119,78,5913,17063,Víctimas de conflicto armado,7418
1031,1063,168,25085,SARDINATA,NORTE DE SANTANDER,1991,3725,5716,119,78,5913,17063,Víctimas reconocidas Sentencia C280 y Auto 119 de 2013,72
1032,1062,167,25082,SANTIAGO,NORTE DE SANTANDER,642,779,1421,30,8,1459,3311,Víctimas de conflicto armado,235
1033,1061,166,25082,SANTIAGO,NORTE DE SANTANDER,642,779,1421,30,8,1459,3311,Víctimas reconocidas Sentencia C280 y Auto 119 de 2013,11
1034,1057,161,25067,PAMPLONITA,NORTE DE SANTANDER,577,1178,1755,46,41,1842,3796,Víctimas de conflicto armado,63
1035,1059,164,25073,SALAZAR,NORTE DE SANTANDER,974,2029,3003,106,47,3156,7487,Víctimas reconocidas Sentencia C280 y Auto 119 de 2013,6
1036,1058,162,25070,RAGONVALIA,NORTE DE SANTANDER,422,1266,1688,23,17,1728,6440,Víctimas reconocidas Sentencia C280 y Auto 119 de 2013,1
1037,1056,160,25064,PAMPLONA,NORTE DE SANTANDER,6506,12079,18585,293,85,18963,43064,Víctimas de conflicto armado,1659
1038,1060,165,25073,SALAZAR,NORTE DE SANTANDER,974,2029,3003,106,47,3156,7487,Víctimas de conflicto armado,528
1039,1066,170,25088,SILOS,NORTE DE SANTANDER,259,1100,1359,18,15,1392,3968,Víctimas de conflicto armado,59
1040,1055,159,25064,PAMPLONA,NORTE DE SANTANDER,6506,12079,18585,293,85,18963,43064,Víctimas reconocidas Sentencia C280 y Auto 119 de 2013,51
1041,1068,172,25091,TEORAMA,NORTE DE SANTANDER,2429,380,2809,99,45,2953,9725,Víctimas de conflicto armado,8926
1042,1069,173,25093,TIBU,NORTE DE SANTANDER,5847,3008,8855,228,99,9182,31208,Víctimas reconocidas Sentencia C280 y Auto 119 de 2013,93
1043,1078,149,25040,GRAMALOTE,NORTE DE SANTANDER,632,1253,1885,38,23,1946,4850,Víctimas de conflicto armado,165
1044,1070,174,25093,TIBU,NORTE DE SANTANDER,5847,3008,8855,228,99,9182,31208,Víctimas de conflicto armado,17805
1045,1071,175,25094,TOLEDO,NORTE DE SANTANDER,1311,2803,4114,135,61,4310,12026,Víctimas reconocidas Sentencia C280 y Auto 119 de 2013,32
1046,1072,176,25094,TOLEDO,NORTE DE SANTANDER,1311,2803,4114,135,61,4310,12026,Víctimas de conflicto armado,680
1047,1073,155,25055,LOURDES,NORTE DE SANTANDER,317,904,1221,53,25,1299,3214,Víctimas de conflicto armado,543
1048,1074,154,25055,LOURDES,NORTE DE SANTANDER,317,904,1221,53,25,1299,3214,Víctimas reconocidas Sentencia C280 y Auto 119 de 2013,7
1049,1075,153,25049,LABATECA,NORTE DE SANTANDER,877,782,1659,32,18,1709,4905,Víctimas de conflicto armado,222
1050,1076,152,25046,HERRAN,NORTE DE SANTANDER,377,769,1146,28,18,1192,3574,Víctimas de conflicto armado,268
1051,1077,151,25043,HACARI,NORTE DE SANTANDER,1562,184,1746,59,34,1839,6906,Víctimas de conflicto armado,5648
1052,1067,171,25091,TEORAMA,NORTE DE SANTANDER,2429,380,2809,99,45,2953,9725,Víctimas reconocidas Sentencia C280 y Auto 119 de 2013,32
1053,1054,158,25061,OCAÑA,NORTE DE SANTANDER,10753,16720,27473,378,126,27977,76057,Víctimas de conflicto armado,29433
1054,1037,129,25007,ARBOLEDAS,NORTE DE SANTANDER,907,2078,2985,58,53,3096,6826,Víctimas reconocidas Sentencia C280 y Auto 119 de 2013,4
1055,1052,150,25043,HACARI,NORTE DE SANTANDER,1562,184,1746,59,34,1839,6906,Víctimas reconocidas Sentencia C280 y Auto 119 de 2013,23
1056,1053,157,25061,OCAÑA,NORTE DE SANTANDER,10753,16720,27473,378,126,27977,76057,Víctimas reconocidas Sentencia C280 y Auto 119 de 2013,488
1057,1029,144,25001,CUCUTA,NORTE DE SANTANDER,83572,157742,241314,3088,1325,245727,542712,Víctimas de conflicto armado,120348
1058,1030,145,25025,CUCUTILLA,NORTE DE SANTANDER,938,1850,2788,72,79,2939,6168,Víctimas reconocidas Sentencia C280 y Auto 119 de 2013,22
1059,1031,146,25025,CUCUTILLA,NORTE DE SANTANDER,938,1850,2788,72,79,2939,6168,Víctimas de conflicto armado,788
1060,1032,143,25001,CUCUTA,NORTE DE SANTANDER,83572,157742,241314,3088,1325,245727,542712,Víctimas reconocidas Sentencia C280 y Auto 119 de 2013,3199
1061,1033,140,25031,CHITAGA,NORTE DE SANTANDER,1056,1729,2785,78,45,2908,7562,Víctimas de conflicto armado,273
1062,1034,141,25022,CONVENCION,NORTE DE SANTANDER,2101,1411,3512,137,83,3732,14827,Víctimas reconocidas Sentencia C280 y Auto 119 de 2013,43
1063,1035,127,25004,ABREGO,NORTE DE SANTANDER,2095,4149,6244,77,56,6377,21133,Víctimas reconocidas Sentencia C280 y Auto 119 de 2013,31
1064,1036,128,25004,ABREGO,NORTE DE SANTANDER,2095,4149,6244,77,56,6377,21133,Víctimas de conflicto armado,3729
1065,1039,131,25010,BOCHALEMA,NORTE DE SANTANDER,1080,1786,2866,50,25,2941,6046,Víctimas reconocidas Sentencia C280 y Auto 119 de 2013,4
1066,1040,132,25010,BOCHALEMA,NORTE DE SANTANDER,1080,1786,2866,50,25,2941,6046,Víctimas de conflicto armado,430
1067,1038,130,25007,ARBOLEDAS,NORTE DE SANTANDER,907,2078,2985,58,53,3096,6826,Víctimas de conflicto armado,759
1068,1042,133,25013,BUCARASICA,NORTE DE SANTANDER,413,985,1398,70,30,1498,4108,Víctimas reconocidas Sentencia C280 y Auto 119 de 2013,14
1069,1043,135,25019,CACHIRA,NORTE DE SANTANDER,531,2060,2591,28,15,2634,6959,Víctimas de conflicto armado,576
1070,1044,136,25016,CACOTA,NORTE DE SANTANDER,413,432,845,24,4,873,2156,Víctimas de conflicto armado,39
1071,1045,137,25028,CHINACOTA,NORTE DE SANTANDER,1983,3351,5334,90,29,5453,11426,Víctimas reconocidas Sentencia C280 y Auto 119 de 2013,18
1072,1046,138,25028,CHINACOTA,NORTE DE SANTANDER,1983,3351,5334,90,29,5453,11426,Víctimas de conflicto armado,1163
1073,1047,139,25031,CHITAGA,NORTE DE SANTANDER,1056,1729,2785,78,45,2908,7562,Víctimas reconocidas Sentencia C280 y Auto 119 de 2013,12
1074,1048,147,25034,DURANIA,NORTE DE SANTANDER,1003,885,1888,32,13,1933,4279,Víctimas reconocidas Sentencia C280 y Auto 119 de 2013,16
1075,1049,134,25013,BUCARASICA,NORTE DE SANTANDER,413,985,1398,70,30,1498,4108,Víctimas de conflicto armado,1286
1076,1050,148,25034,DURANIA,NORTE DE SANTANDER,1003,885,1888,32,13,1933,4279,Víctimas de conflicto armado,358
1077,1051,156,25058,MUTISCUA,NORTE DE SANTANDER,499,605,1104,21,9,1134,2664,Víctimas de conflicto armado,23
1078,1041,142,25022,CONVENCION,NORTE DE SANTANDER,2101,1411,3512,137,83,3732,14827,Víctimas de conflicto armado,12635
1079,1086,520,64019,SIBUNDOY,PUTUMAYO,2499,1783,4282,77,75,4434,10309,Víctimas de conflicto armado,6188
1080,1090,511,64007,COLON,PUTUMAYO,1072,804,1876,19,17,1912,4244,Víctimas reconocidas Sentencia C280 y Auto 119 de 2013,13
1081,1089,516,64023,ORITO,PUTUMAYO,6165,1820,7985,155,86,8226,25937,Víctimas de conflicto armado,11339
1082,1087,518,64016,SANTIAGO,PUTUMAYO,1359,881,2240,48,32,2320,5929,Víctimas de conflicto armado,1885
1083,1085,512,64007,COLON,PUTUMAYO,1072,804,1876,19,17,1912,4244,Víctimas de conflicto armado,1605
1084,1088,517,64016,SANTIAGO,PUTUMAYO,1359,881,2240,48,32,2320,5929,Víctimas reconocidas Sentencia C280 y Auto 119 de 2013,10
1085,1083,521,64030,VILLAGARZON,PUTUMAYO,2869,2757,5626,114,54,5794,15777,Víctimas reconocidas Sentencia C280 y Auto 119 de 2013,96
1086,1082,519,64019,SIBUNDOY,PUTUMAYO,2499,1783,4282,77,75,4434,10309,Víctimas reconocidas Sentencia C280 y Auto 119 de 2013,67
1087,1081,522,64030,VILLAGARZON,PUTUMAYO,2869,2757,5626,114,54,5794,15777,Víctimas de conflicto armado,8473
1088,1080,515,64023,ORITO,PUTUMAYO,6165,1820,7985,155,86,8226,25937,Víctimas reconocidas Sentencia C280 y Auto 119 de 2013,129
1089,1079,514,64001,MOCOA,PUTUMAYO,7718,5105,12823,159,84,13066,35245,Víctimas de conflicto armado,55742
1090,1084,513,64001,MOCOA,PUTUMAYO,7718,5105,12823,159,84,13066,35245,Víctimas reconocidas Sentencia C280 y Auto 119 de 2013,329
1091,1112,80,26020,CIRCASIA,QUINDIO,3343,5837,9180,131,53,9364,21943,Víctimas reconocidas Sentencia C280 y Auto 119 de 2013,64
1092,1111,85,26030,FILANDIA,QUINDIO,1522,2627,4149,68,39,4256,10343,Víctimas de conflicto armado,879
1093,1110,84,26030,FILANDIA,QUINDIO,1522,2627,4149,68,39,4256,10343,Víctimas reconocidas Sentencia C280 y Auto 119 de 2013,46
1094,1109,83,26025,CORDOBA,QUINDIO,872,1028,1900,35,25,1960,5090,Víctimas de conflicto armado,693
1095,1108,82,26025,CORDOBA,QUINDIO,872,1028,1900,35,25,1960,5090,Víctimas reconocidas Sentencia C280 y Auto 119 de 2013,17
1096,1107,81,26020,CIRCASIA,QUINDIO,3343,5837,9180,131,53,9364,21943,Víctimas de conflicto armado,1875
1097,1106,76,26005,BUENAVISTA,QUINDIO,441,564,1005,17,6,1028,2857,Víctimas reconocidas Sentencia C280 y Auto 119 de 2013,12
1098,1105,79,26010,CALARCA,QUINDIO,8767,14557,23324,377,262,23963,58297,Víctimas de conflicto armado,6649
1099,1104,78,26010,CALARCA,QUINDIO,8767,14557,23324,377,262,23963,58297,Víctimas reconocidas Sentencia C280 y Auto 119 de 2013,309
1100,1102,87,26040,GENOVA,QUINDIO,987,1739,2726,55,29,2810,7384,Víctimas de conflicto armado,1893
1101,1103,77,26005,BUENAVISTA,QUINDIO,441,564,1005,17,6,1028,2857,Víctimas de conflicto armado,446
1102,1100,74,26001,ARMENIA,QUINDIO,43835,59049,102884,1205,913,105002,247873,Víctimas reconocidas Sentencia C280 y Auto 119 de 2013,1263
1103,1101,75,26001,ARMENIA,QUINDIO,43835,59049,102884,1205,913,105002,247873,Víctimas de conflicto armado,31373
1104,1092,95,26090,SALENTO,QUINDIO,853,1666,2519,32,27,2578,5762,Víctimas de conflicto armado,825
1105,1093,94,26090,SALENTO,QUINDIO,853,1666,2519,32,27,2578,5762,Víctimas reconocidas Sentencia C280 y Auto 119 de 2013,16
1106,1094,93,26080,QUIMBAYA,QUINDIO,4528,7156,11684,154,211,12049,29792,Víctimas de conflicto armado,3666
1107,1091,89,26060,MONTENEGRO,QUINDIO,3398,8140,11538,227,108,11873,33103,Víctimas de conflicto armado,4363
1108,1096,90,26070,PIJAO,QUINDIO,815,1523,2338,34,13,2385,6022,Víctimas reconocidas Sentencia C280 y Auto 119 de 2013,62
1109,1097,88,26060,MONTENEGRO,QUINDIO,3398,8140,11538,227,108,11873,33103,Víctimas reconocidas Sentencia C280 y Auto 119 de 2013,199
1110,1098,91,26070,PIJAO,QUINDIO,815,1523,2338,34,13,2385,6022,Víctimas de conflicto armado,1879
1111,1099,86,26040,GENOVA,QUINDIO,987,1739,2726,55,29,2810,7384,Víctimas reconocidas Sentencia C280 y Auto 119 de 2013,36
1112,1095,92,26080,QUIMBAYA,QUINDIO,4528,7156,11684,154,211,12049,29792,Víctimas reconocidas Sentencia C280 y Auto 119 de 2013,167
1113,1123,346,24062,MISTRATO,RISARALDA,1926,1716,3642,65,58,3765,11096,Víctimas de conflicto armado,2011
1114,1130,347,24001,PEREIRA,RISARALDA,75063,87598,162661,2278,836,165775,393135,Víctimas reconocidas Sentencia C280 y Auto 119 de 2013,2099
1115,1129,352,24094,SANTUARIO,RISARALDA,1473,2113,3586,119,70,3775,12258,Víctimas de conflicto armado,3040
1116,1128,351,24094,SANTUARIO,RISARALDA,1473,2113,3586,119,70,3775,12258,Víctimas reconocidas Sentencia C280 y Auto 119 de 2013,68
1117,1127,350,24078,QUINCHIA,RISARALDA,4144,3734,7878,259,184,8321,19821,Víctimas de conflicto armado,6287
1118,1126,349,24078,QUINCHIA,RISARALDA,4144,3734,7878,259,184,8321,19821,Víctimas reconocidas Sentencia C280 y Auto 119 de 2013,74
1119,1125,348,24001,PEREIRA,RISARALDA,75063,87598,162661,2278,836,165775,393135,Víctimas de conflicto armado,71333
1120,1124,344,24054,MARSELLA,RISARALDA,2067,3350,5417,97,88,5602,15561,Víctimas de conflicto armado,1095
1121,1122,339,24025,DOSQUEBRADAS,RISARALDA,28055,37995,66050,1044,364,67458,154003,Víctimas reconocidas Sentencia C280 y Auto 119 de 2013,441
1122,1118,338,24013,BALBOA,RISARALDA,891,1074,1965,44,23,2032,5565,Víctimas de conflicto armado,1029
1123,1120,345,24062,MISTRATO,RISARALDA,1926,1716,3642,65,58,3765,11096,Víctimas reconocidas Sentencia C280 y Auto 119 de 2013,79
1124,1119,336,24008,APIA,RISARALDA,1265,2404,3669,84,47,3800,10487,Víctimas de conflicto armado,1916
1125,1121,335,24008,APIA,RISARALDA,1265,2404,3669,84,47,3800,10487,Víctimas reconocidas Sentencia C280 y Auto 119 de 2013,81
1126,1117,337,24013,BALBOA,RISARALDA,891,1074,1965,44,23,2032,5565,Víctimas reconocidas Sentencia C280 y Auto 119 de 2013,27
1127,1116,340,24025,DOSQUEBRADAS,RISARALDA,28055,37995,66050,1044,364,67458,154003,Víctimas de conflicto armado,7422
1128,1115,341,24029,GUATICA,RISARALDA,1240,2443,3683,67,45,3795,10351,Víctimas reconocidas Sentencia C280 y Auto 119 de 2013,150
1129,1114,342,24029,GUATICA,RISARALDA,1240,2443,3683,67,45,3795,10351,Víctimas de conflicto armado,2946
1130,1113,343,24054,MARSELLA,RISARALDA,2067,3350,5417,97,88,5602,15561,Víctimas reconocidas Sentencia C280 y Auto 119 de 2013,50
1131,1233,358,27010,ARATOCA,SANTANDER,1328,1251,2579,51,50,2680,6477,Víctimas de conflicto armado,102
1132,1199,356,27007,ALBANIA,SANTANDER,656,508,1164,15,21,1200,3290,Víctimas de conflicto armado,23
1133,1200,357,27010,ARATOCA,SANTANDER,1328,1251,2579,51,50,2680,6477,Víctimas reconocidas Sentencia C280 y Auto 119 de 2013,5
1134,1201,360,27013,BARBOSA,SANTANDER,4413,4552,8965,162,64,9191,24199,Víctimas de conflicto armado,1728
1135,1205,363,27019,BARRANCABERMEJA,SANTANDER,38260,37440,75700,1153,402,77255,167609,Víctimas reconocidas Sentencia C280 y Auto 119 de 2013,1253
1136,1203,359,27013,BARBOSA,SANTANDER,4413,4552,8965,162,64,9191,24199,Víctimas reconocidas Sentencia C280 y Auto 119 de 2013,31
1137,1204,361,27016,BARICHARA,SANTANDER,1452,1085,2537,51,20,2608,6261,Víctimas reconocidas Sentencia C280 y Auto 119 de 2013,2
1138,1197,354,27004,AGUADA,SANTANDER,165,182,347,6,8,361,1524,Víctimas de conflicto armado,50
1139,1202,399,27085,GALAN,SANTANDER,434,603,1037,31,14,1082,2536,Víctimas de conflicto armado,221
1140,1196,353,27004,AGUADA,SANTANDER,165,182,347,6,8,361,1524,Víctimas reconocidas Sentencia C280 y Auto 119 de 2013,2
1141,1192,396,27080,FLORIAN,SANTANDER,1115,550,1665,22,16,1703,5159,Víctimas de conflicto armado,122
1142,1194,394,27079,ENCISO,SANTANDER,595,702,1297,30,18,1345,3267,Víctimas de conflicto armado,57
1143,1193,395,27080,FLORIAN,SANTANDER,1115,550,1665,22,16,1703,5159,Víctimas reconocidas Sentencia C280 y Auto 119 de 2013,6
1144,1206,389,27052,CONTRATACION,SANTANDER,762,554,1316,30,25,1371,2920,Víctimas de conflicto armado,388
1145,1191,397,27082,FLORIDABLANCA,SANTANDER,36189,50640,86829,870,167,87866,178805,Víctimas reconocidas Sentencia C280 y Auto 119 de 2013,386
1146,1190,398,27082,FLORIDABLANCA,SANTANDER,36189,50640,86829,870,167,87866,178805,Víctimas de conflicto armado,16641
1147,1189,400,27088,GAMBITA,SANTANDER,603,497,1100,19,16,1135,3239,Víctimas de conflicto armado,37
1148,1188,402,27091,GIRON,SANTANDER,17099,28052,45151,549,114,45814,105643,Víctimas de conflicto armado,15767
1149,1187,403,27094,GUACA,SANTANDER,766,1215,1981,38,33,2052,5140,Víctimas reconocidas Sentencia C280 y Auto 119 de 2013,6
1150,1186,401,27091,GIRON,SANTANDER,17099,28052,45151,549,114,45814,105643,Víctimas reconocidas Sentencia C280 y Auto 119 de 2013,354
1151,1185,414,27121,LEBRIJA,SANTANDER,3857,8738,12595,175,61,12831,29381,Víctimas reconocidas Sentencia C280 y Auto 119 de 2013,121
1152,1184,413,27120,LANDAZURI,SANTANDER,1484,1336,2820,173,62,3055,9356,Víctimas de conflicto armado,2762
1153,1195,392,27076,ENCINO,SANTANDER,405,244,649,26,17,692,2123,Víctimas de conflicto armado,340
1154,1207,388,27052,CONTRATACION,SANTANDER,762,554,1316,30,25,1371,2920,Víctimas reconocidas Sentencia C280 y Auto 119 de 2013,4
1155,1211,384,27045,CIMITARRA,SANTANDER,3718,5480,9198,271,79,9548,28154,Víctimas reconocidas Sentencia C280 y Auto 119 de 2013,105
1156,1209,386,27046,CONCEPCION,SANTANDER,642,1015,1657,62,165,1884,4893,Víctimas de conflicto armado,377
1157,1183,412,27120,LANDAZURI,SANTANDER,1484,1336,2820,173,62,3055,9356,Víctimas reconocidas Sentencia C280 y Auto 119 de 2013,39
1158,1232,376,27040,CEPITA,SANTANDER,584,318,902,25,16,943,1771,Víctimas de conflicto armado,16
1159,1231,364,27019,BARRANCABERMEJA,SANTANDER,38260,37440,75700,1153,402,77255,167609,Víctimas de conflicto armado,61359
1160,1230,365,27022,BETULIA,SANTANDER,620,833,1453,39,11,1503,3989,Víctimas reconocidas Sentencia C280 y Auto 119 de 2013,17
1161,1229,366,27022,BETULIA,SANTANDER,620,833,1453,39,11,1503,3989,Víctimas de conflicto armado,135
1162,1228,367,27025,BOLIVAR,SANTANDER,1400,1271,2671,98,76,2845,8280,Víctimas reconocidas Sentencia C280 y Auto 119 de 2013,5
1163,1227,368,27025,BOLIVAR,SANTANDER,1400,1271,2671,98,76,2845,8280,Víctimas de conflicto armado,1158
1164,1226,369,27001,BUCARAMANGA,SANTANDER,100143,122985,223128,1982,457,225567,495063,Víctimas reconocidas Sentencia C280 y Auto 119 de 2013,2004
1165,1225,370,27001,BUCARAMANGA,SANTANDER,100143,122985,223128,1982,457,225567,495063,Víctimas de conflicto armado,98006
1166,1224,371,27028,CABRERA,SANTANDER,446,232,678,10,7,695,1644,Víctimas de conflicto armado,11
1167,1223,372,27031,CALIFORNIA,SANTANDER,152,532,684,19,5,708,1676,Víctimas de conflicto armado,28
1168,1222,373,27034,CAPITANEJO,SANTANDER,672,1103,1775,32,33,1840,4870,Víctimas reconocidas Sentencia C280 y Auto 119 de 2013,8
1169,1221,374,27034,CAPITANEJO,SANTANDER,672,1103,1775,32,33,1840,4870,Víctimas de conflicto armado,148
1170,1220,375,27037,CARCASI,SANTANDER,509,1058,1567,61,23,1651,3656,Víctimas de conflicto armado,85
1171,1219,377,27043,CERRITO,SANTANDER,949,1109,2058,82,37,2177,4803,Víctimas reconocidas Sentencia C280 y Auto 119 de 2013,2
1172,1218,362,27016,BARICHARA,SANTANDER,1452,1085,2537,51,20,2608,6261,Víctimas de conflicto armado,374
1173,1217,378,27043,CERRITO,SANTANDER,949,1109,2058,82,37,2177,4803,Víctimas de conflicto armado,686
1174,1216,379,27061,CHARALA,SANTANDER,2148,1353,3501,53,28,3582,9583,Víctimas reconocidas Sentencia C280 y Auto 119 de 2013,5
1175,1215,380,27061,CHARALA,SANTANDER,2148,1353,3501,53,28,3582,9583,Víctimas de conflicto armado,320
1176,1214,381,27064,CHARTA,SANTANDER,372,941,1313,18,8,1339,3218,Víctimas de conflicto armado,224
1177,1213,382,27067,CHIMA,SANTANDER,558,299,857,31,25,913,2338,Víctimas de conflicto armado,351
1178,1212,383,27070,CHIPATA,SANTANDER,687,273,960,12,17,989,4142,Víctimas de conflicto armado,49
1179,1210,385,27045,CIMITARRA,SANTANDER,3718,5480,9198,271,79,9548,28154,Víctimas de conflicto armado,4381
1180,1208,387,27049,CONFINES,SANTANDER,321,524,845,14,6,865,2348,Víctimas de conflicto armado,83
1181,1182,411,27115,JORDAN,SANTANDER,194,191,385,3,11,399,1107,Víctimas de conflicto armado,10
1182,1198,355,27007,ALBANIA,SANTANDER,656,508,1164,15,21,1200,3290,Víctimas reconocidas Sentencia C280 y Auto 119 de 2013,5
1183,1180,409,27106,GUEPSA,SANTANDER,885,548,1433,20,9,1462,4173,Víctimas de conflicto armado,185
1184,1152,437,27172,RIONEGRO,SANTANDER,2675,5347,8022,179,95,8296,22075,Víctimas de conflicto armado,2439
1185,1151,390,27055,COROMORO,SANTANDER,795,691,1486,67,41,1594,4141,Víctimas de conflicto armado,282
1186,1150,435,27163,PINCHOTE,SANTANDER,742,577,1319,25,13,1357,3181,Víctimas de conflicto armado,63
1187,1148,416,27127,MACARAVITA,SANTANDER,456,347,803,21,16,840,2244,Víctimas de conflicto armado,91
1188,1147,434,27163,PINCHOTE,SANTANDER,742,577,1319,25,13,1357,3181,Víctimas reconocidas Sentencia C280 y Auto 119 de 2013,5
1189,1146,418,27130,MALAGA,SANTANDER,2538,4086,6624,178,39,6841,15663,Víctimas de conflicto armado,1263
1190,1145,419,27133,MATANZA,SANTANDER,866,1334,2200,39,17,2256,4853,Víctimas reconocidas Sentencia C280 y Auto 119 de 2013,16
1191,1144,420,27133,MATANZA,SANTANDER,866,1334,2200,39,17,2256,4853,Víctimas de conflicto armado,975
1192,1143,421,27136,MOGOTES,SANTANDER,1165,1501,2666,128,60,2854,7512,Víctimas reconocidas Sentencia C280 y Auto 119 de 2013,18
1193,1142,422,27136,MOGOTES,SANTANDER,1165,1501,2666,128,60,2854,7512,Víctimas de conflicto armado,370
1194,1153,455,27223,ZAPATOCA,SANTANDER,984,1563,2547,51,22,2620,7366,Víctimas de conflicto armado,428
1195,1141,423,27139,MOLAGAVITA,SANTANDER,531,830,1361,38,34,1433,3592,Víctimas de conflicto armado,27
1196,1139,425,27142,OCAMONTE,SANTANDER,1129,489,1618,35,17,1670,3773,Víctimas de conflicto armado,48
1197,1138,427,27145,OIBA,SANTANDER,1543,1931,3474,79,29,3582,8450,Víctimas de conflicto armado,341
1198,1137,426,27145,OIBA,SANTANDER,1543,1931,3474,79,29,3582,8450,Víctimas reconocidas Sentencia C280 y Auto 119 de 2013,5
1199,1136,433,27160,PIEDECUESTA,SANTANDER,19145,28817,47962,739,340,49041,100462,Víctimas de conflicto armado,10645
1200,1135,432,27160,PIEDECUESTA,SANTANDER,19145,28817,47962,739,340,49041,100462,Víctimas reconocidas Sentencia C280 y Auto 119 de 2013,363
1201,1134,431,27157,PARAMO,SANTANDER,791,754,1545,33,8,1586,3201,Víctimas de conflicto armado,45
1202,1133,430,27151,PALMAR,SANTANDER,397,183,580,6,8,594,1353,Víctimas de conflicto armado,32
1203,1132,429,27151,PALMAR,SANTANDER,397,183,580,6,8,594,1353,Víctimas reconocidas Sentencia C280 y Auto 119 de 2013,3
1204,1131,428,27148,ONZAGA,SANTANDER,634,554,1188,41,47,1276,3795,Víctimas de conflicto armado,64
1205,1181,410,27109,HATO,SANTANDER,464,310,774,19,24,817,1825,Víctimas de conflicto armado,470
1206,1140,417,27130,MALAGA,SANTANDER,2538,4086,6624,178,39,6841,15663,Víctimas reconocidas Sentencia C280 y Auto 119 de 2013,44
1207,1154,454,27223,ZAPATOCA,SANTANDER,984,1563,2547,51,22,2620,7366,Víctimas reconocidas Sentencia C280 y Auto 119 de 2013,21
1208,1149,424,27142,OCAMONTE,SANTANDER,1129,489,1618,35,17,1670,3773,Víctimas reconocidas Sentencia C280 y Auto 119 de 2013,10
1209,1156,452,27221,VILLANUEVA,SANTANDER,912,1427,2339,34,16,2389,6336,Víctimas reconocidas Sentencia C280 y Auto 119 de 2013,3
1210,1179,408,27106,GUEPSA,SANTANDER,885,548,1433,20,9,1462,4173,Víctimas reconocidas Sentencia C280 y Auto 119 de 2013,2
1211,1178,407,27103,GUAVATA,SANTANDER,808,495,1303,28,14,1345,4470,Víctimas de conflicto armado,93
1212,1177,406,27100,GUAPOTA,SANTANDER,381,357,738,27,9,774,1834,Víctimas de conflicto armado,12
1213,1176,405,27097,GUADALUPE,SANTANDER,607,908,1515,30,22,1567,4334,Víctimas de conflicto armado,113
1214,1175,404,27094,GUACA,SANTANDER,766,1215,1981,38,33,2052,5140,Víctimas de conflicto armado,72
1215,1174,393,27079,ENCISO,SANTANDER,595,702,1297,30,18,1345,3267,Víctimas reconocidas Sentencia C280 y Auto 119 de 2013,5
1216,1155,453,27221,VILLANUEVA,SANTANDER,912,1427,2339,34,16,2389,6336,Víctimas de conflicto armado,46
1217,1172,436,27172,RIONEGRO,SANTANDER,2675,5347,8022,179,95,8296,22075,Víctimas reconocidas Sentencia C280 y Auto 119 de 2013,38
1218,1171,438,27196,SIMACOTA,SANTANDER,1237,970,2207,66,17,2290,5898,Víctimas reconocidas Sentencia C280 y Auto 119 de 2013,42
1219,1170,439,27196,SIMACOTA,SANTANDER,1237,970,2207,66,17,2290,5898,Víctimas de conflicto armado,1491
1220,1169,440,27199,SOCORRO,SANTANDER,4348,5049,9397,123,36,9556,23774,Víctimas reconocidas Sentencia C280 y Auto 119 de 2013,51
1221,1168,441,27199,SOCORRO,SANTANDER,4348,5049,9397,123,36,9556,23774,Víctimas de conflicto armado,1132
1222,1173,391,27058,CURITI,SANTANDER,1526,1741,3267,76,35,3378,8217,Víctimas de conflicto armado,67
1223,1166,443,27202,SUAITA,SANTANDER,1395,1189,2584,65,29,2678,8256,Víctimas de conflicto armado,440
1224,1165,444,27205,SUCRE,SANTANDER,698,1104,1802,28,28,1858,5837,Víctimas reconocidas Sentencia C280 y Auto 119 de 2013,1
1225,1164,445,27205,SUCRE,SANTANDER,698,1104,1802,28,28,1858,5837,Víctimas de conflicto armado,433
1226,1163,446,27208,SURATA,SANTANDER,478,805,1283,40,20,1343,3016,Víctimas reconocidas Sentencia C280 y Auto 119 de 2013,5
1227,1162,447,27208,SURATA,SANTANDER,478,805,1283,40,20,1343,3016,Víctimas de conflicto armado,1042
1228,1161,448,27211,TONA,SANTANDER,808,1149,1957,66,16,2039,4950,Víctimas de conflicto armado,178
1229,1160,449,27220,VELEZ,SANTANDER,3254,2742,5996,160,37,6193,16435,Víctimas reconocidas Sentencia C280 y Auto 119 de 2013,5
1230,1159,450,27220,VELEZ,SANTANDER,3254,2742,5996,160,37,6193,16435,Víctimas de conflicto armado,748
1231,1158,415,27121,LEBRIJA,SANTANDER,3857,8738,12595,175,61,12831,29381,Víctimas de conflicto armado,5510
1232,1157,451,27219,VETAS,SANTANDER,92,476,568,10,2,580,1466,Víctimas de conflicto armado,27
1233,1167,442,27202,SUAITA,SANTANDER,1395,1189,2584,65,29,2678,8256,Víctimas reconocidas Sentencia C280 y Auto 119 de 2013,8
1234,1249,640,28080,MORROA,SUCRE,3322,1753,5075,101,46,5222,12813,Víctimas reconocidas Sentencia C280 y Auto 119 de 2013,44
1235,1250,641,28080,MORROA,SUCRE,3322,1753,5075,101,46,5222,12813,Víctimas de conflicto armado,3513
1236,1251,642,28100,OVEJAS,SUCRE,5328,2019,7347,58,65,7470,20135,Víctimas reconocidas Sentencia C280 y Auto 119 de 2013,151
1237,1252,643,28100,OVEJAS,SUCRE,5328,2019,7347,58,65,7470,20135,Víctimas de conflicto armado,18629
1238,1253,644,28120,PALMITO,SUCRE,2323,1011,3334,29,31,3394,9642,Víctimas reconocidas Sentencia C280 y Auto 119 de 2013,49
1239,1259,651,28280,SUCRE,SUCRE,3100,2459,5559,52,59,5670,20688,Víctimas de conflicto armado,9889
1240,1255,646,28160,SAMPUES,SUCRE,6816,4596,11412,170,126,11708,30974,Víctimas reconocidas Sentencia C280 y Auto 119 de 2013,308
1241,1256,647,28160,SAMPUES,SUCRE,6816,4596,11412,170,126,11708,30974,Víctimas de conflicto armado,3466
1242,1257,648,28001,SINCELEJO,SUCRE,37461,31435,68896,771,722,70389,195898,Víctimas reconocidas Sentencia C280 y Auto 119 de 2013,6157
1243,1258,649,28001,SINCELEJO,SUCRE,37461,31435,68896,771,722,70389,195898,Víctimas de conflicto armado,160404
1244,1248,639,28060,MAJAGUAL,SUCRE,3935,2857,6792,52,85,6929,26077,Víctimas de conflicto armado,2895
1245,1254,645,28120,PALMITO,SUCRE,2323,1011,3334,29,31,3394,9642,Víctimas de conflicto armado,1498
1246,1247,637,28049,GUARANDA,SUCRE,1811,1701,3512,48,24,3584,12792,Víctimas de conflicto armado,7594
1247,1239,629,28020,CAIMITO,SUCRE,2126,623,2749,24,41,2814,8757,Víctimas de conflicto armado,661
1248,1245,635,28041,COVEÑAS,SUCRE,1918,1915,3833,41,24,3898,10921,Víctimas de conflicto armado,961
1249,1246,636,28049,GUARANDA,SUCRE,1811,1701,3512,48,24,3584,12792,Víctimas reconocidas Sentencia C280 y Auto 119 de 2013,551
1250,1234,638,28060,MAJAGUAL,SUCRE,3935,2857,6792,52,85,6929,26077,Víctimas reconocidas Sentencia C280 y Auto 119 de 2013,82
1251,1235,650,28280,SUCRE,SUCRE,3100,2459,5559,52,59,5670,20688,Víctimas reconocidas Sentencia C280 y Auto 119 de 2013,45
1252,1237,627,28010,BUENAVISTA,SUCRE,2187,993,3180,22,48,3250,9619,Víctimas de conflicto armado,9646
1253,1238,628,28020,CAIMITO,SUCRE,2126,623,2749,24,41,2814,8757,Víctimas reconocidas Sentencia C280 y Auto 119 de 2013,77
1254,1236,626,28010,BUENAVISTA,SUCRE,2187,993,3180,22,48,3250,9619,Víctimas reconocidas Sentencia C280 y Auto 119 de 2013,45
1255,1240,630,28045,CHALAN,SUCRE,869,466,1335,19,40,1394,4403,Víctimas reconocidas Sentencia C280 y Auto 119 de 2013,5
1256,1241,631,28045,CHALAN,SUCRE,869,466,1335,19,40,1394,4403,Víctimas de conflicto armado,4426
1257,1242,632,28040,COROZAL,SUCRE,10907,6973,17880,206,120,18206,45886,Víctimas reconocidas Sentencia C280 y Auto 119 de 2013,692
1258,1243,633,28040,COROZAL,SUCRE,10907,6973,17880,206,120,18206,45886,Víctimas de conflicto armado,29513
1259,1244,634,28041,COVEÑAS,SUCRE,1918,1915,3833,41,24,3898,10921,Víctimas reconocidas Sentencia C280 y Auto 119 de 2013,84
1260,1309,311,29124,VILLAHERMOSA,TOLIMA,605,1732,2337,39,43,2419,7181,Víctimas de conflicto armado,866
1261,1313,295,29091,PRADO,TOLIMA,1121,1799,2920,43,36,2999,7933,Víctimas reconocidas Sentencia C280 y Auto 119 de 2013,12
1262,1312,294,29089,PLANADAS,TOLIMA,2818,3081,5899,198,108,6205,19662,Víctimas de conflicto armado,4365
1263,1311,297,29094,PURIFICACION,TOLIMA,4045,4139,8184,105,50,8339,20186,Víctimas reconocidas Sentencia C280 y Auto 119 de 2013,10
1264,1310,312,29127,VILLARRICA,TOLIMA,671,1070,1741,42,10,1793,5204,Víctimas de conflicto armado,584
1265,1314,309,29121,VENADILLO,TOLIMA,1929,2478,4407,52,29,4488,11721,Víctimas de conflicto armado,1056
1266,1308,310,29124,VILLAHERMOSA,TOLIMA,605,1732,2337,39,43,2419,7181,Víctimas reconocidas Sentencia C280 y Auto 119 de 2013,4
1267,1303,305,29105,SALDAÑA,TOLIMA,1463,2954,4417,53,22,4492,12416,Víctimas de conflicto armado,346
1268,1306,301,29100,RONCESVALLES,TOLIMA,768,728,1496,48,22,1566,4175,Víctimas de conflicto armado,396
1269,1305,307,29115,SUAREZ,TOLIMA,700,1095,1795,15,3,1813,4386,Víctimas de conflicto armado,105
1270,1304,306,29115,SUAREZ,TOLIMA,700,1095,1795,15,3,1813,4386,Víctimas reconocidas Sentencia C280 y Auto 119 de 2013,2
1271,1315,300,29097,RIOBLANCO,TOLIMA,2209,2317,4526,119,133,4778,16033,Víctimas de conflicto armado,5643
1272,1302,304,29105,SALDAÑA,TOLIMA,1463,2954,4417,53,22,4492,12416,Víctimas reconocidas Sentencia C280 y Auto 119 de 2013,6
1273,1301,303,29103,ROVIRA,TOLIMA,1776,4287,6063,152,57,6272,19506,Víctimas de conflicto armado,2804
1274,1300,302,29103,ROVIRA,TOLIMA,1776,4287,6063,152,57,6272,19506,Víctimas reconocidas Sentencia C280 y Auto 119 de 2013,26
1275,1307,308,29121,VENADILLO,TOLIMA,1929,2478,4407,52,29,4488,11721,Víctimas reconocidas Sentencia C280 y Auto 119 de 2013,34
1276,1316,299,29097,RIOBLANCO,TOLIMA,2209,2317,4526,119,133,4778,16033,Víctimas reconocidas Sentencia C280 y Auto 119 de 2013,6
1277,1322,249,29028,CASABIANCA,TOLIMA,922,953,1875,22,29,1926,4940,Víctimas de conflicto armado,556
1278,1318,253,29031,COELLO,TOLIMA,1488,1157,2645,34,22,2701,7709,Víctimas de conflicto armado,202
1279,1299,254,29034,COYAIMA,TOLIMA,3404,2081,5485,81,119,5685,17192,Víctimas reconocidas Sentencia C280 y Auto 119 de 2013,12
1280,1333,255,29034,COYAIMA,TOLIMA,3404,2081,5485,81,119,5685,17192,Víctimas de conflicto armado,1269
1281,1332,239,29007,ALVARADO,TOLIMA,1312,1415,2727,36,24,2787,8422,Víctimas de conflicto armado,456
1282,1334,292,29088,PIEDRAS,TOLIMA,974,959,1933,25,10,1968,5387,Víctimas de conflicto armado,169
1283,1331,240,29010,AMBALEMA,TOLIMA,1216,1126,2342,47,14,2403,6922,Víctimas reconocidas Sentencia C280 y Auto 119 de 2013,4
1284,1330,241,29010,AMBALEMA,TOLIMA,1216,1126,2342,47,14,2403,6922,Víctimas de conflicto armado,362
1285,1329,242,29013,ANZOATEGUI,TOLIMA,693,1576,2269,42,51,2362,7462,Víctimas reconocidas Sentencia C280 y Auto 119 de 2013,41
1286,1317,238,29004,ALPUJARRA,TOLIMA,452,1005,1457,46,14,1517,3725,Víctimas de conflicto armado,617
1287,1328,243,29013,ANZOATEGUI,TOLIMA,693,1576,2269,42,51,2362,7462,Víctimas de conflicto armado,2334
1288,1326,245,29019,ATACO,TOLIMA,1658,3451,5109,68,75,5252,14957,Víctimas de conflicto armado,6523
1289,1325,246,29022,CAJAMARCA,TOLIMA,1823,4084,5907,85,54,6046,16190,Víctimas reconocidas Sentencia C280 y Auto 119 de 2013,18
1290,1324,247,29022,CAJAMARCA,TOLIMA,1823,4084,5907,85,54,6046,16190,Víctimas de conflicto armado,2828
1291,1323,248,29028,CASABIANCA,TOLIMA,922,953,1875,22,29,1926,4940,Víctimas reconocidas Sentencia C280 y Auto 119 de 2013,1
1292,1321,250,29040,CHAPARRAL,TOLIMA,5476,6694,12170,172,174,12516,38101,Víctimas reconocidas Sentencia C280 y Auto 119 de 2013,30
1293,1320,251,29040,CHAPARRAL,TOLIMA,5476,6694,12170,172,174,12516,38101,Víctimas de conflicto armado,8537
1294,1319,252,29031,COELLO,TOLIMA,1488,1157,2645,34,22,2701,7709,Víctimas reconocidas Sentencia C280 y Auto 119 de 2013,1
1295,1327,244,29019,ATACO,TOLIMA,1658,3451,5109,68,75,5252,14957,Víctimas reconocidas Sentencia C280 y Auto 119 de 2013,55
1296,1298,256,29037,CUNDAY,TOLIMA,1075,1516,2591,31,26,2648,7208,Víctimas reconocidas Sentencia C280 y Auto 119 de 2013,8
1297,1262,259,29043,DOLORES,TOLIMA,1109,1563,2672,52,35,2759,6729,Víctimas de conflicto armado,2115
1298,1296,257,29037,CUNDAY,TOLIMA,1075,1516,2591,31,26,2648,7208,Víctimas de conflicto armado,1595
1299,1297,291,29088,PIEDRAS,TOLIMA,974,959,1933,25,10,1968,5387,Víctimas reconocidas Sentencia C280 y Auto 119 de 2013,3
1300,1274,298,29094,PURIFICACION,TOLIMA,4045,4139,8184,105,50,8339,20186,Víctimas de conflicto armado,973
1301,1273,261,29046,ESPINAL,TOLIMA,8388,14623,23011,324,111,23446,58148,Víctimas de conflicto armado,2709
1302,1272,262,29049,FALAN,TOLIMA,1147,995,2142,52,36,2230,5702,Víctimas reconocidas Sentencia C280 y Auto 119 de 2013,4
1303,1271,263,29049,FALAN,TOLIMA,1147,995,2142,52,36,2230,5702,Víctimas de conflicto armado,552
1304,1270,265,29052,FLANDES,TOLIMA,2373,4194,6567,88,38,6693,17194,Víctimas de conflicto armado,471
1305,1269,272,29064,HONDA,TOLIMA,3549,4788,8337,150,62,8549,23027,Víctimas reconocidas Sentencia C280 y Auto 119 de 2013,34
1306,1268,266,29055,FRESNO,TOLIMA,2741,5542,8283,183,100,8566,26101,Víctimas reconocidas Sentencia C280 y Auto 119 de 2013,43
1307,1267,267,29055,FRESNO,TOLIMA,2741,5542,8283,183,100,8566,26101,Víctimas de conflicto armado,2902
1308,1266,268,29058,GUAMO,TOLIMA,3042,5783,8825,114,75,9014,25766,Víctimas reconocidas Sentencia C280 y Auto 119 de 2013,11
1309,1265,269,29058,GUAMO,TOLIMA,3042,5783,8825,114,75,9014,25766,Víctimas de conflicto armado,728
1310,1264,270,29061,HERVEO,TOLIMA,724,1128,1852,40,40,1932,5922,Víctimas reconocidas Sentencia C280 y Auto 119 de 2013,12
1311,1263,271,29061,HERVEO,TOLIMA,724,1128,1852,40,40,1932,5922,Víctimas de conflicto armado,673
1312,1261,260,29046,ESPINAL,TOLIMA,8388,14623,23011,324,111,23446,58148,Víctimas reconocidas Sentencia C280 y Auto 119 de 2013,70
1313,1260,296,29091,PRADO,TOLIMA,1121,1799,2920,43,36,2999,7933,Víctimas de conflicto armado,3445
1314,1276,258,29043,DOLORES,TOLIMA,1109,1563,2672,52,35,2759,6729,Víctimas reconocidas Sentencia C280 y Auto 119 de 2013,4
1315,1277,264,29052,FLANDES,TOLIMA,2373,4194,6567,88,38,6693,17194,Víctimas reconocidas Sentencia C280 y Auto 119 de 2013,20
1316,1275,293,29089,PLANADAS,TOLIMA,2818,3081,5899,198,108,6205,19662,Víctimas reconocidas Sentencia C280 y Auto 119 de 2013,23
1317,1279,274,29001,IBAGUE,TOLIMA,70780,108879,179659,2184,656,182499,392554,Víctimas reconocidas Sentencia C280 y Auto 119 de 2013,1030
1318,1295,276,29067,ICONONZO,TOLIMA,1498,1335,2833,49,30,2912,8395,Víctimas reconocidas Sentencia C280 y Auto 119 de 2013,20
1319,1294,277,29067,ICONONZO,TOLIMA,1498,1335,2833,49,30,2912,8395,Víctimas de conflicto armado,2086
1320,1293,278,29070,LERIDA,TOLIMA,2748,2812,5560,77,28,5665,15269,Víctimas reconocidas Sentencia C280 y Auto 119 de 2013,12
1321,1292,279,29070,LERIDA,TOLIMA,2748,2812,5560,77,28,5665,15269,Víctimas de conflicto armado,1591
1322,1278,273,29064,HONDA,TOLIMA,3549,4788,8337,150,62,8549,23027,Víctimas de conflicto armado,888
1323,1290,281,29073,LIBANO,TOLIMA,5158,5238,10396,226,145,10767,32895,Víctimas de conflicto armado,14279
1324,1289,282,29079,MELGAR,TOLIMA,3102,7663,10765,130,47,10942,27553,Víctimas reconocidas Sentencia C280 y Auto 119 de 2013,89
1325,1288,283,29079,MELGAR,TOLIMA,3102,7663,10765,130,47,10942,27553,Víctimas de conflicto armado,2748
1326,1291,280,29073,LIBANO,TOLIMA,5158,5238,10396,226,145,10767,32895,Víctimas reconocidas Sentencia C280 y Auto 119 de 2013,129
1327,1286,285,29082,NATAGAIMA,TOLIMA,2970,2331,5301,78,41,5420,15411,Víctimas reconocidas Sentencia C280 y Auto 119 de 2013,19
1328,1285,286,29082,NATAGAIMA,TOLIMA,2970,2331,5301,78,41,5420,15411,Víctimas de conflicto armado,4015
1329,1284,287,29085,ORTEGA,TOLIMA,3247,4872,8119,227,159,8505,23729,Víctimas reconocidas Sentencia C280 y Auto 119 de 2013,6
1330,1283,288,29085,ORTEGA,TOLIMA,3247,4872,8119,227,159,8505,23729,Víctimas de conflicto armado,1263
1331,1282,289,29087,PALOCABILDO,TOLIMA,1003,1412,2415,49,24,2488,7468,Víctimas reconocidas Sentencia C280 y Auto 119 de 2013,31
1332,1281,290,29087,PALOCABILDO,TOLIMA,1003,1412,2415,49,24,2488,7468,Víctimas de conflicto armado,650
1333,1280,275,29001,IBAGUE,TOLIMA,70780,108879,179659,2184,656,182499,392554,Víctimas de conflicto armado,101740
1334,1287,284,29080,MURILLO,TOLIMA,409,690,1099,56,14,1169,3782,Víctimas de conflicto armado,578
1335,1335,209,68004,CARURU,VAUPES,382,76,458,7,0,465,1721,Víctimas de conflicto armado,357
1336,1336,210,68001,MITU,VAUPES,2705,872,3577,30,20,3627,15576,Víctimas reconocidas Sentencia C280 y Auto 119 de 2013,18
1337,1337,212,68017,TARAIRA,VAUPES,243,65,308,1,36,345,1377,Víctimas de conflicto armado,71
1338,1338,211,68001,MITU,VAUPES,2705,872,3577,30,20,3627,15576,Víctimas de conflicto armado,6485
1339,1339,213,68022,YAVARATE,VAUPES,278,37,315,0,1,316,1035,Víctimas de conflicto armado,17
1340,1340,4,72006,CUMARIBO,VICHADA,2717,952,3669,52,42,3763,19420,Víctimas reconocidas Sentencia C280 y Auto 119 de 2013,209
1341,1341,5,72006,CUMARIBO,VICHADA,2717,952,3669,52,42,3763,19420,Víctimas de conflicto armado,1230
